All_Poverty,M_Poverty,F_Poverty,FIPS,Med_Income,Med_Income_White,Med_Income_Black,Med_Income_Nat_Am,Med_Income_Asian,Hispanic,M_With,M_Without,F_With,F_Without,All_With,All_Without,fips_x,Incidence_Rate,Avg_Ann_Incidence,fips_y,Mortality_Rate,Avg_Ann_Deaths
553,334,219,2013,61518.0,72639.0,31250.0,54750.0,62679.0,51250.0,876,1317,566,540,1442,1857,2013,,2.0,2013,,
499,273,226,2016,84306.0,97321.0,93750.0,48750.0,81250.0,77500.0,2470,769,1707,564,4177,1333,2016,,2.0,2016,,
23914,10698,13216,2020,78326.0,87235.0,50535.0,53935.0,63757.0,53926.0,120747,23245,122426,21393,243173,44638,2020,61.5,131.0,2020,47.3,96.0
4364,2199,2165,2050,51012.0,92647.0,73661.0,41594.0,110625.0,160114.0,6396,2708,6627,1774,13023,4482,2050,62.7,6.0,2050,58.3,5.0
69,33,36,2060,79750.0,88000.0,,63333.0,,25625.0,419,124,349,67,768,191,2060,,2.0,2060,,
254,139,115,2068,81544.0,81029.0,,47500.0,,,822,253,674,250,1496,503,2068,,2.0,2068,,
894,446,448,2070,54173.0,81161.0,,42212.0,,86458.0,1678,900,1837,546,3515,1446,2070,,2.0,2070,,
7752,3523,4229,2090,71068.0,74242.0,56353.0,48333.0,56339.0,55284.0,40605,6957,40210,5322,80815,12279,2090,58.1,36.0,2090,54.0,31.0
135,74,61,2100,58750.0,67888.0,,45714.0,,,960,422,944,228,1904,650,2100,,2.0,2100,,
2110,1145,965,2110,85746.0,90553.0,106964.0,57821.0,80893.0,76083.0,13739,2433,13582,2213,27321,4646,2110,35.1,9.0,2110,34.4,8.0
5558,2596,2962,2122,63684.0,64663.0,122660.0,46458.0,58125.0,64148.0,22391,6435,21668,5433,44059,11868,2122,64.9,39.0,2122,50.1,28.0
1640,792,848,2130,64222.0,73313.0,,45536.0,45859.0,83250.0,5339,1428,5527,1082,10866,2510,2130,88.3,12.0,2130,70.8,9.0
1552,962,590,2150,70887.0,82857.0,26827.0,48179.0,56585.0,87000.0,4941,1920,4943,1479,9884,3399,2150,74.7,7.0,2150,76.2,6.0
247,119,128,2164,50781.0,72500.0,,38482.0,,,445,286,513,230,958,516,2164,,2.0,2164,,
9454,4346,5108,2170,72983.0,74141.0,55577.0,56724.0,53789.0,77367.0,39282,9314,37751,8084,77033,17398,2170,69.7,51.0,2170,53.9,37.0
2592,1399,1193,2180,48868.0,85455.0,,37277.0,78056.0,86607.0,3506,1605,3430,1114,6936,2719,2180,103.6,6.0,2180,96.1,6.0
976,532,444,2185,72576.0,86250.0,107500.0,59554.0,126964.0,88563.0,4847,1248,2579,910,7426,2158,2185,153.4,6.0,2185,124.9,5.0
1824,951,873,2188,63648.0,99444.0,,52227.0,69375.0,,2690,1455,2542,1021,5232,2476,2188,67.6,3.0,2188,,
798,424,374,2220,70376.0,81029.0,143125.0,40625.0,75000.0,58333.0,3635,841,3591,692,7226,1533,2220,44.0,4.0,2220,39.6,3.0
1011,507,504,2240,62670.0,71349.0,51563.0,20774.0,33750.0,78750.0,2889,853,2454,666,5343,1519,2240,76.8,5.0,2240,,
1029,598,431,2261,78810.0,82090.0,,45000.0,105417.0,,3670,1292,3566,884,7236,2176,2261,66.1,6.0,2261,60.8,4.0
35,25,10,2282,72500.0,76250.0,,45625.0,127188.0,,289,78,217,59,506,137,2282,,2.0,2282,,
1252,666,586,2290,38491.0,63000.0,,29750.0,76250.0,,1795,1225,1692,907,3487,2132,2290,58.3,3.0,2290,,
7057,2983,4074,1001,51281.0,56854.0,32073.0,,2499.0,61296.0,23500,2781,25417,2727,48917,5508,1001,74.9,43.0,1001,59.3,34.0
25798,12018,13780,1003,50254.0,52594.0,26967.0,92670.0,36250.0,42468.0,79768,13644,88015,11343,167783,24987,1003,66.9,170.0,1003,48.0,121.0
6421,2856,3565,1005,32964.0,45039.0,21171.0,,,27132.0,9578,2163,10750,1569,20328,3732,1005,74.6,25.0,1005,61.3,20.0
3488,1495,1993,1007,38678.0,42263.0,27793.0,,,43750.0,9342,1012,9421,995,18763,2007,1007,86.4,23.0,1007,67.8,17.0
9552,4593,4959,1009,45813.0,46601.0,31507.0,61310.0,,35271.0,24629,3642,25922,3017,50551,6659,1009,69.7,51.0,1009,59.9,43.0
2486,981,1505,1011,31938.0,52930.0,24595.0,,,,4088,1066,4191,762,8279,1828,1011,65.8,9.0,1011,29.7,4.0
5094,2073,3021,1013,32229.0,42922.0,23453.0,,90833.0,,8129,1223,9482,1236,17611,2459,1013,58.3,17.0,1013,52.6,15.0
23325,9500,13825,1015,41703.0,46399.0,26071.0,48409.0,,30575.0,47992,7440,53518,6245,101510,13685,1015,84.2,120.0,1015,59.9,86.0
7273,3091,4182,1017,34177.0,42336.0,25442.0,,62417.0,,13928,2198,15131,2476,29059,4674,1017,75.4,34.0,1017,63.1,29.0
4918,2421,2497,1019,36296.0,36679.0,32973.0,,11313.0,,11401,1404,11730,1137,23131,2541,1019,82.4,32.0,1019,54.0,21.0
8288,3871,4417,1021,41627.0,43395.0,35189.0,83564.0,22981.0,28939.0,18164,3252,18371,3712,36535,6964,1021,73.9,39.0,1021,66.0,34.0
3093,1206,1887,1023,33536.0,45321.0,21661.0,,,,5384,934,6098,850,11482,1784,1023,49.2,10.0,1023,43.0,9.0
6107,2495,3612,1025,32011.0,41390.0,19650.0,,,2499.0,9881,1825,11159,1934,21040,3759,1025,69.5,23.0,1025,43.9,15.0
2201,902,1299,1027,35327.0,37166.0,30343.0,12679.0,,24914.0,5518,1022,5839,886,11357,1908,1027,83.3,16.0,1027,69.1,13.0
2508,1069,1439,1029,38056.0,38886.0,30335.0,,,17431.0,6234,1017,6582,1013,12816,2030,1029,74.9,14.0,1029,59.7,12.0
8581,3867,4714,1031,46729.0,51998.0,26605.0,46607.0,39063.0,32372.0,20688,2891,22567,2783,43255,5674,1031,71.5,43.0,1031,55.1,33.0
9406,4124,5282,1033,40576.0,44296.0,28778.0,,,30994.0,23057,3007,24955,3003,48012,6010,1033,75.9,57.0,1033,61.2,46.0
4320,2011,2309,1035,24900.0,32746.0,17366.0,,,13365.0,4925,1217,5227,1449,10152,2666,1035,73.5,14.0,1035,60.2,12.0
2073,961,1112,1037,31212.0,42727.0,23473.0,,,,4474,866,4605,805,9079,1671,1037,82.6,14.0,1037,68.9,11.0
7515,3263,4252,1039,36444.0,39636.0,21875.0,26389.0,33177.0,51131.0,15536,2520,16877,2437,32413,4957,1039,83.0,44.0,1039,71.9,39.0
2288,1068,1220,1041,36022.0,42771.0,21614.0,55227.0,,72868.0,5847,939,6229,748,12076,1687,1041,61.5,11.0,1041,47.3,9.0
14814,6760,8054,1043,38971.0,39378.0,33333.0,,,21888.0,33641,6024,34557,5978,68198,12002,1043,69.6,73.0,1043,61.4,63.0
9306,4092,5214,1045,45028.0,49655.0,26807.0,43088.0,73636.0,25115.0,19228,3179,21602,3161,40830,6340,1045,76.7,44.0,1045,63.6,37.0
14580,5889,8691,1047,27306.0,51431.0,20462.0,,49583.0,,16398,2891,19599,2951,35997,5842,1047,76.2,39.0,1047,65.3,33.0
13133,5783,7350,1049,38192.0,38909.0,27629.0,,65114.0,27912.0,28735,6363,29767,5509,58502,11872,1049,60.8,51.0,1049,56.3,46.0
10334,4413,5921,1051,53555.0,58246.0,34370.0,48563.0,49342.0,29038.0,31679,3669,36728,3425,68407,7094,1051,78.1,66.0,1051,66.1,55.0
8609,3695,4914,1053,32330.0,39557.0,21925.0,32321.0,,,14055,3261,14958,3333,29013,6594,1053,75.5,36.0,1053,67.0,32.0
20078,8854,11224,1055,39220.0,41841.0,24950.0,35387.0,120714.0,35795.0,42271,7457,46984,6023,89255,13480,1055,81.9,110.0,1055,67.7,90.0
3055,1449,1606,1057,34680.0,36892.0,17270.0,,,30625.0,7557,832,7568,751,15125,1583,1057,77.3,19.0,1057,58.3,14.0
7020,2598,4422,1059,35372.0,36562.0,27340.0,27529.0,,34308.0,12966,2200,13441,2767,26407,4967,1059,72.4,28.0,1059,65.8,25.0
6149,2689,3460,1061,36024.0,37725.0,24296.0,34063.0,,35023.0,10913,2091,11495,1977,22408,4068,1061,90.3,35.0,1061,71.2,27.0
3479,1562,1917,1063,20541.0,45136.0,17731.0,,,,3304,777,4081,484,7385,1261,1063,87.9,10.0,1063,34.5,5.0
4011,1638,2373,1065,32714.0,47035.0,25127.0,,,34055.0,6051,997,7096,854,13147,1851,1065,71.0,14.0,1065,57.8,11.0
2657,1085,1572,1067,41997.0,50725.0,22207.0,,,41477.0,7002,1164,7934,926,14936,2090,1067,66.5,17.0,1067,56.3,14.0
18746,7893,10853,1069,41571.0,48967.0,24982.0,35662.0,45000.0,34063.0,42001,6928,47530,6187,89531,13115,1069,70.8,88.0,1069,56.1,69.0
9415,4398,5017,1071,37745.0,38158.0,20238.0,48947.0,,21840.0,21752,4072,23118,3424,44870,7496,1071,80.9,58.0,1071,64.0,46.0
121029,52750,68279,1073,45610.0,60497.0,31867.0,35396.0,55052.0,34768.0,266456,40710,307962,36469,574418,77179,1073,65.1,482.0,1073,51.5,381.0
3382,1302,2080,1075,35450.0,37267.0,19792.0,,,,5876,885,6248,980,12124,1865,1075,80.4,17.0,1075,72.2,15.0
16232,6772,9460,1077,43125.0,45208.0,25992.0,22697.0,59750.0,36034.0,38885,5228,42682,5167,81567,10395,1077,69.3,87.0,1077,56.8,71.0
6225,2780,3445,1079,40003.0,40061.0,30417.0,50372.0,28472.0,28482.0,14223,2042,15306,1773,29529,3815,1079,88.1,37.0,1079,70.0,29.0
34561,15869,18692,1081,44570.0,50270.0,29991.0,,52870.0,40330.0,64110,8577,69209,7141,133319,15718,1081,59.4,71.0,1081,57.1,66.0
12075,5206,6869,1083,49570.0,51636.0,38971.0,,,30285.0,35387,5442,38770,5206,74157,10648,1083,73.4,69.0,1083,55.9,51.0
3035,1353,1682,1085,25876.0,56045.0,19510.0,,,,4122,883,5036,563,9158,1446,1085,57.6,8.0,1085,44.0,6.0
4636,2060,2576,1087,30738.0,39335.0,28249.0,23750.0,,64271.0,7564,1437,9797,1011,17361,2448,1087,57.9,15.0,1087,41.1,10.0
46436,21195,25241,1089,57993.0,66922.0,35950.0,49044.0,64365.0,43009.0,145531,20878,156037,19760,301568,40638,1089,64.8,236.0,1089,50.4,179.0
5244,2056,3188,1091,32042.0,54205.0,20262.0,,,,8133,1209,9532,1205,17665,2414,1091,61.6,17.0,1091,51.9,15.0
5960,2805,3155,1093,32299.0,32698.0,27727.0,70972.0,36010.0,35757.0,12619,1902,13590,1618,26209,3520,1093,74.2,33.0,1093,51.7,23.0
18794,8426,10368,1095,38983.0,39540.0,25688.0,,93125.0,24069.0,37272,8805,40331,7023,77603,15828,1095,79.4,90.0,1095,66.6,75.0
77917,31927,45990,1097,43809.0,53398.0,28066.0,42353.0,48063.0,40875.0,163094,28997,185337,28790,348431,57787,1097,75.4,347.0,1097,63.3,289.0
6901,2912,3989,1099,27257.0,37849.0,17029.0,50536.0,,14554.0,8832,1717,9448,2005,18280,3722,1099,62.3,19.0,1099,52.9,16.0
49918,21699,28219,1101,44369.0,61342.0,34180.0,61684.0,72083.0,39923.0,88803,15281,105296,13407,194099,28688,1101,61.0,144.0,1101,49.9,117.0
18936,7640,11296,1103,45751.0,48739.0,25944.0,101364.0,62917.0,34331.0,48705,9071,51963,8345,100668,17416,1103,80.4,116.0,1103,60.5,88.0
3373,1510,1863,1105,24537.0,43906.0,19336.0,,,,3926,666,4539,757,8465,1423,1105,83.1,11.0,1105,60.3,8.0
4801,2116,2685,1107,30330.0,41392.0,18722.0,,,36833.0,8174,1403,8582,1095,16756,2498,1107,65.6,18.0,1107,57.5,16.0
8158,3810,4348,1109,32825.0,44427.0,21852.0,47188.0,,30375.0,13996,1760,15437,1754,29433,3514,1109,61.8,22.0,1109,47.2,16.0
4511,2048,2463,1111,36924.0,40027.0,28219.0,,,,9324,1666,9877,1545,19201,3211,1111,75.5,24.0,1111,58.5,18.0
12054,4782,7272,1113,37049.0,44182.0,30005.0,21734.0,,67639.0,22282,4430,24884,4777,47166,9207,1113,78.7,47.0,1113,64.0,38.0
13417,6115,7302,1115,51859.0,53010.0,42069.0,,107875.0,48042.0,36930,4549,38204,4318,75134,8867,1115,74.7,72.0,1115,65.0,61.0
16693,7492,9201,1117,70187.0,72574.0,58780.0,61964.0,81713.0,40143.0,88004,9927,95944,7945,183948,17872,1117,57.1,108.0,1117,47.3,88.0
5372,2187,3185,1119,19501.0,48636.0,15730.0,,70000.0,,4522,1343,6152,1187,10674,2530,1119,55.5,9.0,1119,51.0,9.0
17950,7613,10337,1121,35155.0,40996.0,24692.0,28681.0,129936.0,33661.0,32170,5151,36501,4860,68671,10011,1121,74.0,74.0,1121,61.0,61.0
9117,3646,5471,1123,39206.0,47741.0,23739.0,11216.0,,27911.0,16879,2385,18924,2428,35803,4813,1123,70.5,41.0,1123,54.5,32.0
36274,15124,21150,1125,46565.0,55568.0,31879.0,37361.0,42649.0,39005.0,85157,10782,93413,9656,178570,20438,1125,72.3,135.0,1125,54.4,100.0
14598,6480,8118,1127,35843.0,36618.0,24898.0,,,30725.0,26799,4750,29620,4050,56419,8800,1127,98.3,89.0,1127,79.8,71.0
3200,1367,1833,1129,42811.0,44052.0,32361.0,53409.0,,39583.0,7140,1263,7114,1352,14254,2615,1129,74.8,16.0,1129,65.3,14.0
4126,1910,2216,1131,23750.0,43516.0,18154.0,,,,4326,879,4850,921,9176,1800,1131,73.2,11.0,1131,61.7,9.0
5157,2035,3122,1133,33194.0,33770.0,,22857.0,,28205.0,10251,1462,10390,1726,20641,3188,1133,90.8,31.0,1133,69.9,24.0
3705,1514,2191,5001,36411.0,42928.0,26242.0,,,27125.0,7568,1273,8583,1068,16151,2341,5001,85.9,21.0,5001,67.8,17.0
4352,1961,2391,5003,34263.0,41506.0,18810.0,,,31333.0,8544,1538,9494,1478,18038,3016,5003,77.0,23.0,5003,58.6,17.0
6452,3062,3390,5005,35396.0,35458.0,,,,61667.0,17259,2372,18915,2026,36174,4398,5005,85.6,71.0,5005,64.3,54.0
28804,13213,15591,5007,56239.0,55511.0,56509.0,44457.0,81290.0,43154.0,100609,16255,105249,14411,205858,30666,5007,56.4,129.0,5007,47.0,106.0
6465,2751,3714,5009,39251.0,39736.0,,10170.0,69297.0,50404.0,15299,2602,16771,2130,32070,4732,5009,67.7,35.0,5009,62.6,33.0
3218,1350,1868,5011,33701.0,42250.0,22500.0,,,26536.0,4534,989,4797,793,9331,1782,5011,86.3,13.0,5011,68.3,11.0
907,409,498,5013,36899.0,43032.0,27891.0,,,34750.0,2227,411,2228,320,4455,731,5013,82.5,6.0,5013,70.2,5.0
5001,2173,2828,5015,36897.0,37029.0,,,,35075.0,11137,2296,11452,2537,22589,4833,5015,59.1,25.0,5015,47.7,20.0
3385,1350,2035,5017,28913.0,43224.0,20722.0,,,,4159,829,4935,763,9094,1592,5017,76.4,12.0,5017,70.2,12.0
4716,1872,2844,5019,35031.0,39805.0,22136.0,,45938.0,35278.0,9169,1412,10481,1349,19650,2761,5019,71.6,19.0,5019,53.3,15.0
3324,1472,1852,5021,32552.0,32251.0,,67143.0,,34779.0,6214,1308,6654,1090,12868,2398,5021,108.7,26.0,5021,80.1,20.0
3676,1696,1980,5023,42905.0,43417.0,,57794.0,,21563.0,10744,1960,10629,2018,21373,3978,5023,83.6,38.0,5023,70.5,32.0
1751,785,966,5025,43158.0,46296.0,21000.0,,,,3802,415,3698,517,7500,932,5025,77.5,9.0,5025,67.0,7.0
5823,2540,3283,5027,36619.0,50998.0,20254.0,11518.0,,21835.0,9961,1427,10874,1642,20835,3069,5027,72.0,21.0,5027,62.6,19.0
4709,2344,2365,5029,37732.0,39860.0,30598.0,31875.0,,20431.0,8987,1322,9349,1275,18336,2597,5029,75.0,21.0,5029,55.1,16.0
19715,8920,10795,5031,42475.0,45806.0,23202.0,25074.0,58452.0,27139.0,40807,8090,44480,7051,85287,15141,5031,74.6,74.0,5031,49.2,48.0
11304,5456,5848,5033,41268.0,41283.0,26806.0,56176.0,40417.0,28695.0,25253,4761,27005,4175,52258,8936,5033,79.1,56.0,5033,61.8,43.0
11802,4745,7057,5035,38004.0,56377.0,25553.0,,62016.0,29967.0,19835,3330,22367,3672,42202,7002,5035,75.6,37.0,5035,72.2,36.0
3461,1459,2002,5037,38103.0,40965.0,21675.0,,58542.0,,6927,1358,7966,1005,14893,2363,5037,77.5,18.0,5037,75.7,17.0
1141,521,620,5039,34084.0,41102.0,26775.0,,48304.0,,3076,490,3215,559,6291,1049,5039,82.2,9.0,5039,74.0,9.0
4029,1628,2401,5041,27197.0,42783.0,17373.0,,,21678.0,4813,911,5534,1048,10347,1959,5041,79.2,13.0,5041,62.8,11.0
5023,2381,2642,5043,32819.0,43676.0,17469.0,,,27736.0,7468,1560,8028,1292,15496,2852,5043,77.3,17.0,5043,66.9,15.0
17768,7625,10143,5045,51223.0,55041.0,29229.0,,48721.0,35547.0,50314,7392,53062,7289,103376,14681,5045,75.9,78.0,5045,61.3,61.0
3854,1651,2203,5047,39285.0,39541.0,,35364.0,,13778.0,7539,1116,7827,1098,15366,2214,5047,77.1,19.0,5047,70.1,17.0
2383,1094,1289,5049,37066.0,36749.0,,21250.0,,21250.0,5109,849,5326,756,10435,1605,5049,64.7,14.0,5049,51.3,11.0
19802,9205,10597,5051,38733.0,40935.0,21917.0,31300.0,,29423.0,37960,8263,42017,7421,79977,15684,5051,80.6,121.0,5051,62.5,95.0
2134,943,1191,5053,46171.0,46808.0,28711.0,23462.0,,19091.0,7806,1002,8160,929,15966,1931,5053,96.1,21.0,5053,66.9,14.0
7572,3161,4411,5055,41286.0,41224.0,,52578.0,,36301.0,18199,3041,18855,2801,37054,5842,5055,89.2,45.0,5055,69.6,34.0
5940,2685,3255,5057,32122.0,37732.0,24145.0,,,20965.0,8639,2045,9584,1824,18223,3869,5057,60.6,17.0,5057,55.6,16.0
5975,2520,3455,5059,40000.0,42384.0,22794.0,,,35676.0,13038,2294,13930,2154,26968,4448,5059,94.2,41.0,5059,75.3,32.0
2910,1276,1634,5061,34229.0,40757.0,22636.0,,,34861.0,5307,1242,5610,1218,10917,2460,5061,96.2,16.0,5061,83.1,14.0
7783,3287,4496,5063,36265.0,36948.0,21810.0,2499.0,,30238.0,15227,2627,15939,2658,31166,5285,5063,82.3,38.0,5063,59.3,27.0
2663,1346,1317,5065,32630.0,32718.0,,,,71250.0,5407,912,5285,1083,10692,1995,5065,55.9,13.0,5065,48.4,11.0
3819,1759,2060,5067,31261.0,32459.0,22179.0,,,,6560,1207,5615,903,12175,2110,5067,104.4,24.0,5067,83.5,19.0
17205,7764,9441,5069,36747.0,46712.0,29051.0,,57330.0,23281.0,28435,4044,32557,4219,60992,8263,5069,97.5,84.0,5069,67.3,58.0
5574,2492,3082,5071,34139.0,35176.0,12500.0,33333.0,32917.0,30070.0,10777,1961,11377,1613,22154,3574,5071,97.2,29.0,5071,67.9,20.0
1731,692,1039,5073,31194.0,41726.0,18917.0,,,,2809,635,3106,588,5915,1223,5073,98.1,12.0,5073,76.8,9.0
3899,1796,2103,5075,32379.0,32373.0,,60469.0,,,6805,1419,7182,1309,13987,2728,5075,102.7,25.0,5075,82.3,20.0
2304,969,1335,5077,28393.0,38894.0,19779.0,,,,3231,875,3863,488,7094,1363,5077,57.0,8.0,5077,61.9,8.0
2257,1003,1254,5079,32580.0,41220.0,20252.0,,,30550.0,3666,768,4639,745,8305,1513,5079,63.4,10.0,5079,59.0,9.0
2402,1074,1328,5081,36205.0,39588.0,24578.0,110625.0,,,5288,1050,5384,837,10672,1887,5081,79.5,14.0,5081,56.6,11.0
4158,1995,2163,5083,35325.0,36390.0,25543.0,250001.0,34000.0,,9588,1364,9291,1510,18879,2874,5083,87.0,27.0,5083,70.4,22.0
8697,3814,4883,5085,53631.0,55487.0,25096.0,,65372.0,40500.0,29648,4044,31951,3462,61599,7506,5085,91.9,62.0,5085,72.3,49.0
3183,1329,1854,5087,37691.0,37747.0,,,,35128.0,6461,1384,6587,1199,13048,2583,5087,67.8,14.0,5087,58.5,12.0
3064,1345,1719,5089,34195.0,34137.0,,72431.0,,17788.0,6880,1224,7080,1120,13960,2344,5089,82.7,26.0,5089,72.5,22.0
8594,3519,5075,5091,40317.0,46144.0,27182.0,,,41029.0,17114,3465,18108,3769,35222,7234,5091,81.2,41.0,5091,73.1,36.0
11781,4964,6817,5093,34612.0,41279.0,25317.0,,31765.0,27438.0,17754,3431,19318,3527,37072,6958,5093,73.6,36.0,5093,70.2,34.0
2501,1078,1423,5095,27647.0,36352.0,15625.0,,,,3037,567,3412,620,6449,1187,5095,89.5,11.0,5095,70.9,9.0
1620,728,892,5097,33037.0,33771.0,,80486.0,,63056.0,3605,881,3865,705,7470,1586,5097,67.5,11.0,5097,50.4,8.0
2424,1176,1248,5099,30691.0,37540.0,24136.0,18173.0,,,3408,824,3731,631,7139,1455,5099,69.2,9.0,5099,76.1,10.0
1637,648,989,5101,34536.0,34583.0,,58281.0,,,3470,553,3379,594,6849,1147,5101,63.9,9.0,5101,64.9,9.0
5948,2211,3737,5103,31293.0,42348.0,21455.0,,,20208.0,10245,1311,11605,1487,21850,2798,5103,84.0,30.0,5103,55.8,20.0
1624,509,1115,5105,42346.0,43539.0,,,,,4607,478,4566,527,9173,1005,5105,98.8,14.0,5105,78.5,11.0
6882,2991,3891,5107,26844.0,43491.0,20277.0,,,,7585,1824,9003,1794,16588,3618,5107,88.1,23.0,5107,90.8,23.0
2199,999,1200,5109,33097.0,33968.0,,,,19917.0,4360,993,4734,847,9094,1840,5109,87.8,13.0,5109,63.5,10.0
5416,2410,3006,5111,33070.0,35219.0,18276.0,26635.0,,22039.0,9578,2099,10369,1842,19947,3941,5111,114.0,36.0,5111,103.5,33.0
4878,2389,2489,5113,33702.0,34098.0,,,,29545.0,8138,1727,8596,1765,16734,3492,5113,67.1,22.0,5113,57.8,18.0
11818,5525,6293,5115,39810.0,40302.0,37102.0,35536.0,63233.0,32760.0,26407,4371,27067,4343,53474,8714,5115,86.3,59.0,5115,72.5,49.0
1766,775,991,5117,35833.0,39059.0,23333.0,,,,3510,522,3650,570,7160,1092,5117,89.0,12.0,5117,71.7,9.0
67908,30871,37037,5119,46140.0,56369.0,31768.0,34158.0,62254.0,33789.0,155362,28215,177974,23280,333336,51495,5119,68.0,277.0,5119,54.7,223.0
3651,1897,1754,5121,34044.0,34327.0,,,,13348.0,7056,1477,7688,1129,14744,2606,5121,83.9,21.0,5121,69.9,18.0
5857,2661,3196,5123,32105.0,36982.0,25924.0,,,20333.0,9159,2301,10761,1502,19920,3803,5123,65.2,20.0,5123,54.4,16.0
10176,4896,5280,5125,55817.0,57215.0,43631.0,28546.0,58375.0,51443.0,48403,6658,52131,5374,100534,12032,5125,73.9,100.0,5125,52.0,69.0
2165,1061,1104,5127,37321.0,37788.0,,,66250.0,34079.0,4655,872,4639,631,9294,1503,5127,91.5,15.0,5127,63.5,10.0
1855,986,869,5129,33083.0,33300.0,,15682.0,,40313.0,3284,668,3306,618,6590,1286,5129,72.1,10.0,5129,65.9,9.0
28975,12570,16405,5131,38575.0,40849.0,21563.0,44592.0,42732.0,29090.0,52036,9869,54137,10109,106173,19978,5131,78.2,108.0,5131,62.1,85.0
3755,1807,1948,5133,36579.0,38305.0,22824.0,,,29724.0,6695,1825,6927,1633,13622,3458,5133,70.4,12.0,5133,60.4,10.0
3944,1700,2244,5135,30691.0,30665.0,,32188.0,243750.0,,6873,1357,7332,1315,14205,2672,5135,89.3,26.0,5135,69.1,21.0
3042,1414,1628,5137,29264.0,29322.0,,,,,5402,908,5237,859,10639,1767,5137,66.5,14.0,5137,58.2,12.0
8172,3577,4595,5139,38678.0,48060.0,26845.0,33571.0,71339.0,30792.0,16488,2920,17939,2885,34427,5805,5139,89.0,46.0,5139,71.6,38.0
3574,1438,2136,5141,32312.0,32155.0,,,,36042.0,6656,1663,7101,1386,13757,3049,5141,65.1,19.0,5141,57.5,17.0
41846,19505,22341,5143,43524.0,46302.0,31528.0,27794.0,50938.0,36705.0,89087,18167,92453,14933,181540,33100,5143,67.1,119.0,5143,52.7,91.0
14175,6412,7763,5145,42554.0,43432.0,24738.0,,,23924.0,32331,6006,34463,5243,66794,11249,5145,91.2,81.0,5145,69.6,61.0
1612,740,872,5147,28993.0,31193.0,20863.0,,,,2662,686,2965,550,5627,1236,5147,108.5,11.0,5147,64.9,7.0
4009,1862,2147,5149,37804.0,38631.0,,90893.0,25671.0,36282.0,8865,1837,9456,1380,18321,3217,5149,88.1,24.0,5149,76.0,21.0
25852,12854,12998,4001,31757.0,42488.0,31761.0,25600.0,59632.0,34178.0,25743,9201,28542,7852,54285,17053,4001,22.9,16.0,4001,17.7,12.0
21102,8595,12507,4003,45075.0,46090.0,66734.0,,61761.0,35446.0,47589,6771,55718,6614,103307,13385,4003,46.9,84.0,4003,37.0,65.0
28824,13662,15162,4005,50234.0,55850.0,29613.0,37171.0,34792.0,46345.0,53505,13515,57656,11293,111161,24808,4005,36.7,39.0,4005,25.6,26.0
11839,5365,6474,4007,39751.0,40745.0,,26274.0,82847.0,40048.0,21863,4070,22671,3830,44534,7900,4007,54.3,52.0,4007,43.8,42.0
7446,3377,4069,4009,45964.0,47676.0,,27984.0,69010.0,46223.0,13834,2323,15164,2098,28998,4421,4009,45.5,16.0,4009,33.8,12.0
1215,538,677,4011,51628.0,48375.0,100682.0,90446.0,,46000.0,4139,584,3643,617,7782,1201,4011,64.0,6.0,4011,41.8,4.0
3824,1851,1973,4012,34466.0,35247.0,,30083.0,,36610.0,8733,1429,8625,1321,17358,2750,4012,54.4,25.0,4012,37.7,18.0
673527,313707,359820,4013,54229.0,56337.0,39059.0,41137.0,70947.0,40294.0,1633881,332342,1747583,275016,3381464,607358,4013,52.2,2059.0,4013,37.2,1463.0
38874,18410,20464,4015,38488.0,38500.0,30859.0,36111.0,56756.0,32186.0,79661,16608,86521,14132,166182,30740,4015,76.6,280.0,4015,59.1,216.0
32141,15025,17116,4017,35921.0,45641.0,,24805.0,42396.0,33107.0,41839,10188,44822,8626,86661,18814,4017,39.6,46.0,4017,31.0,35.0
187250,86251,100999,4019,46162.0,48801.0,36278.0,29877.0,45337.0,36745.0,404930,70973,444390,59712,849320,130685,4019,50.9,628.0,4019,37.3,464.0
63201,28120,35081,4021,49477.0,50501.0,52107.0,26310.0,66494.0,43213.0,155409,24692,163328,23603,318737,48295,4021,45.5,201.0,4021,33.6,146.0
10970,5162,5808,4023,40140.0,41819.0,101563.0,,73472.0,34613.0,18361,3991,20136,4339,38497,8330,4023,36.1,19.0,4023,23.1,12.0
34117,16249,17868,4025,44748.0,45086.0,50781.0,37228.0,71563.0,36870.0,90324,14466,95351,14369,185675,28835,4025,51.9,203.0,4025,38.1,151.0
40508,18351,22157,4027,40743.0,41798.0,44348.0,26896.0,69716.0,35293.0,76032,20388,81132,17421,157164,37809,4027,48.0,115.0,4027,30.9,74.0
194639,87343,107296,6001,75619.0,82824.0,42093.0,52793.0,95216.0,57291.0,681621,88190,732996,70544,1414617,158734,6001,46.0,687.0,6001,33.4,495.0
195,106,89,6003,52917.0,59423.0,,35625.0,,,512,142,400,77,912,219,6003,,2.0,6003,,
4191,1886,2305,6005,54171.0,54719.0,,37578.0,107995.0,31971.0,14369,1631,15820,1060,30189,2691,6005,58.7,38.0,6005,47.2,31.0
47532,23533,23999,6007,43444.0,44755.0,27031.0,40987.0,39435.0,35563.0,92483,16326,98566,12938,191049,29264,6007,61.4,169.0,6007,46.0,126.0
5590,2433,3157,6009,53233.0,55242.0,,,,54750.0,19250,2526,20634,1972,39884,4498,6009,52.3,41.0,6009,40.2,31.0
3171,1590,1581,6011,52168.0,54123.0,,55208.0,,45092.0,8848,2183,8582,1592,17430,3775,6011,56.0,11.0,6011,48.9,10.0
117915,52269,65646,6013,80185.0,85459.0,50343.0,56250.0,100536.0,58299.0,474034,57497,510094,48931,984128,106428,6013,49.2,554.0,6013,36.1,404.0
5207,2385,2822,6015,40847.0,42245.0,9141.0,50689.0,,24340.0,10237,1462,11012,1310,21249,2772,6015,78.4,25.0,6015,59.9,19.0
18831,9082,9749,6017,69584.0,70097.0,98140.0,48958.0,116625.0,47863.0,81148,9011,83819,7027,164967,16038,6017,50.0,116.0,6017,34.3,79.0
252187,117772,134415,6019,45233.0,50386.0,26110.0,36631.0,50683.0,36022.0,379453,88591,410573,66736,790026,155327,6019,50.8,411.0,6019,36.2,291.0
5721,2544,3177,6021,39349.0,41957.0,26389.0,36483.0,19181.0,35973.0,11142,2797,11606,2187,22748,4984,6021,61.2,19.0,6021,43.8,14.0
28158,13202,14956,6023,42197.0,44095.0,28504.0,27097.0,32823.0,35800.0,54679,11986,56929,10368,111608,22354,6023,56.4,86.0,6023,42.7,65.0
40114,18036,22078,6025,41079.0,42589.0,57321.0,36250.0,81128.0,37110.0,66068,14972,71962,14770,138030,29742,6025,44.3,69.0,6025,27.0,42.0
2019,907,1112,6027,45955.0,46694.0,65625.0,37148.0,,45514.0,7794,1063,8106,971,15900,2034,6027,45.7,13.0,6027,36.5,11.0
195744,87585,108159,6029,49026.0,50315.0,32429.0,33876.0,71908.0,39686.0,344109,73189,358933,60514,703042,133703,6029,55.7,371.0,6029,41.4,270.0
29900,13392,16508,6031,46481.0,48190.0,40991.0,38816.0,63568.0,37384.0,53683,10579,57172,9062,110855,19641,6031,48.8,54.0,6031,34.4,37.0
15597,7932,7665,6033,35578.0,37724.0,24111.0,32750.0,42075.0,31597.0,25756,5905,27121,4688,52877,10593,6033,73.7,70.0,6033,56.0,53.0
3563,1814,1749,6035,51555.0,51130.0,48500.0,61905.0,,46667.0,10144,1107,9576,1144,19720,2251,6035,60.9,19.0,6035,51.3,15.0
1800265,823612,976653,6037,56196.0,62124.0,40665.0,46394.0,66356.0,45320.0,3904322,997326,4230137,837175,8134459,1834501,6037,39.9,3701.0,6037,31.1,2876.0
33968,15721,18247,6039,45073.0,45095.0,35661.0,33516.0,53889.0,39124.0,57486,14771,62076,10344,119562,25115,6039,51.8,76.0,6039,37.0,53.0
20964,9707,11257,6041,93257.0,101129.0,54225.0,,89630.0,48813.0,111107,10737,123055,8224,234162,18961,6041,41.6,145.0,6041,29.7,106.0
2651,1264,1387,6043,47681.0,48529.0,,46111.0,,37976.0,7924,871,8092,729,16016,1600,6043,54.6,17.0,6043,43.3,13.0
17527,8215,9312,6045,42980.0,44531.0,19323.0,30598.0,49500.0,35090.0,35930,7213,38036,5443,73966,12656,6045,52.2,62.0,6045,42.1,51.0
67417,32269,35148,6047,42462.0,45504.0,32605.0,35347.0,50354.0,37404.0,106738,23878,112633,17643,219371,41521,6047,56.9,120.0,6047,41.1,85.0
1673,833,840,6049,37860.0,38375.0,,35385.0,32813.0,26445.0,3678,797,3881,584,7559,1381,6049,43.7,6.0,6049,34.8,5.0
684,344,340,6051,56944.0,61066.0,,,86250.0,45076.0,5317,1929,5413,1413,10730,3342,6051,24.6,3.0,6051,,
69475,31992,37483,6053,58783.0,59228.0,59634.0,58361.0,68208.0,48236.0,160439,42733,173038,33794,333477,76527,6053,42.6,163.0,6053,31.7,121.0
14020,6923,7097,6055,71379.0,72220.0,73003.0,50369.0,99486.0,52459.0,59832,8787,62340,7435,122172,16222,6055,53.3,92.0,6055,40.6,70.0
12367,5582,6785,6057,56521.0,56538.0,,60134.0,71462.0,45869.0,41033,6956,43911,5718,84944,12674,6057,47.3,75.0,6057,31.4,50.0
395483,182267,213216,6059,76509.0,79914.0,66555.0,55123.0,80739.0,56510.0,1292176,237090,1361429,208099,2653605,445189,6059,44.1,1326.0,6059,32.6,979.0
32427,15480,16947,6061,73948.0,73888.0,85580.0,60563.0,102714.0,54294.0,158349,18543,172630,13950,330979,32493,6061,49.6,222.0,6061,34.3,154.0
2687,1168,1519,6063,47333.0,48809.0,,38377.0,23355.0,30918.0,8108,1407,8361,926,16469,2333,6063,44.2,15.0,6063,36.5,12.0
379985,175705,204280,6065,56603.0,58994.0,52127.0,46960.0,71601.0,48510.0,916746,207979,974823,175978,1891569,383957,6065,47.2,1031.0,6065,37.1,808.0
262251,122854,139397,6067,55987.0,60420.0,38792.0,48547.0,61374.0,45042.0,607503,96682,666343,79357,1273846,176039,6067,56.9,793.0,6067,42.6,595.0
6202,2722,3480,6069,71077.0,71115.0,75972.0,63750.0,92727.0,59295.0,24382,4284,25574,3155,49956,7439,6069,40.2,18.0,6069,29.9,15.0
397766,178898,218868,6071,53433.0,55421.0,40705.0,41581.0,72134.0,49633.0,825890,177988,886691,159538,1712581,337526,6071,49.5,807.0,6071,39.0,625.0
454876,210952,243924,6073,64309.0,65480.0,50227.0,56297.0,81673.0,47896.0,1301142,234576,1380888,206949,2682030,441525,6073,49.0,1485.0,6073,36.0,1097.0
109524,52571,56953,6075,81294.0,100091.0,29800.0,36198.0,69577.0,57948.0,384329,40788,380762,30288,765091,71076,6075,49.0,459.0,6075,34.4,324.0
129390,59724,69666,6077,53274.0,56313.0,37428.0,37697.0,61128.0,44550.0,290726,55049,311300,42817,602026,97866,6077,56.8,353.0,6077,44.8,277.0
38630,18816,19814,6079,60691.0,61694.0,63224.0,46250.0,59421.0,48178.0,117241,17433,120210,14696,237451,32129,6079,46.9,161.0,6079,34.7,120.0
59232,26750,32482,6081,93623.0,97207.0,56213.0,70792.0,107531.0,61383.0,330032,36082,349501,29233,679533,65315,6081,45.3,375.0,6081,30.4,254.0
68017,32772,35245,6083,63985.0,66814.0,51695.0,57699.0,68710.0,49516.0,175112,37490,186064,30108,361176,67598,6083,42.1,189.0,6083,29.3,134.0
175690,81461,94229,6085,96310.0,94691.0,64219.0,55508.0,116152.0,61124.0,840137,93794,849441,75798,1689578,169592,6085,41.1,705.0,6085,27.6,472.0
39053,17482,21571,6087,67256.0,69441.0,63977.0,32056.0,68528.0,48648.0,115040,17940,121172,13853,236212,31793,6087,37.6,99.0,6087,28.4,74.0
31707,14584,17123,6089,44620.0,45180.0,39193.0,40240.0,45983.0,36457.0,73691,13334,79630,10912,153321,24246,6089,62.5,154.0,6089,48.6,119.0
438,180,258,6091,42833.0,42396.0,,,,18194.0,1238,258,1387,108,2625,366,6091,,2.0,6091,,
10026,4814,5212,6093,37170.0,38610.0,17784.0,22230.0,39500.0,30472.0,18728,2957,19573,2444,38301,5401,6093,60.5,44.0,6093,48.0,35.0
55534,24891,30643,6095,66828.0,71497.0,50790.0,50324.0,83281.0,55834.0,175710,24415,193177,19391,368887,43806,6095,58.1,246.0,6095,44.3,186.0
57179,26643,30536,6097,64240.0,66800.0,60091.0,53208.0,69885.0,51334.0,208988,31276,224981,25613,433969,56889,6097,49.5,288.0,6097,38.4,223.0
105927,48153,57774,6099,50125.0,51489.0,37772.0,37049.0,57620.0,42964.0,217812,41373,231370,33483,449182,74856,6099,57.4,273.0,6099,42.1,200.0
16743,7675,9068,6101,52017.0,53549.0,57432.0,55156.0,51821.0,40639.0,38662,7984,41134,6258,79796,14242,6101,56.3,56.0,6101,48.0,48.0
12313,5604,6709,6103,41001.0,40919.0,,38125.0,58109.0,43545.0,26592,4414,27736,3843,54328,8257,6103,65.2,54.0,6103,49.9,40.0
2562,1226,1336,6105,34974.0,35474.0,,18205.0,,,5379,1332,5355,1094,10734,2426,6105,66.6,15.0,6105,52.4,11.0
125775,60834,64941,6107,42031.0,42513.0,22458.0,36199.0,57851.0,34677.0,180176,44296,190135,35140,370311,79436,6107,47.9,174.0,6107,40.7,145.0
7010,3092,3918,6109,50306.0,50883.0,30972.0,43182.0,52330.0,48225.0,22107,3017,23557,2159,45664,5176,6109,58.0,52.0,6109,37.6,35.0
91880,42180,49700,6111,77348.0,76839.0,74474.0,59457.0,103602.0,59009.0,347674,63746,371628,51009,719302,114755,6111,41.5,344.0,6111,30.3,250.0
39688,18185,21503,6113,54989.0,59421.0,36208.0,53810.0,46215.0,46885.0,87463,12481,95866,9946,183329,22427,6113,42.3,74.0,6113,34.3,60.0
15862,7384,8478,6115,46892.0,48312.0,37386.0,31712.0,52528.0,41341.0,29943,5357,31024,4787,60967,10144,6115,68.1,44.0,6115,55.3,35.0
64241,29134,35107,8001,58946.0,60451.0,43031.0,56750.0,58984.0,46978.0,189978,44652,197245,35868,387223,80520,8001,52.6,182.0,8001,39.0,133.0
4396,1771,2625,8003,32395.0,32353.0,24931.0,54000.0,,24268.0,6483,1147,7379,814,13862,1961,8003,47.9,7.0,8003,30.5,5.0
67679,31140,36539,8005,63265.0,68266.0,46143.0,44038.0,66821.0,44998.0,252809,43197,271608,35597,524417,78794,8005,47.5,253.0,8005,33.7,177.0
1405,661,744,8007,46646.0,48588.0,,,,35361.0,4749,1386,4721,1212,9470,2598,8007,31.7,6.0,8007,22.7,4.0
736,308,428,8009,38000.0,38833.0,,,,32500.0,1438,301,1643,218,3081,519,8009,78.2,5.0,8009,,
923,473,450,8011,36791.0,37982.0,,8929.0,,31154.0,1493,338,1601,192,3094,530,8011,44.0,4.0,8011,,
42167,20822,21345,8013,70961.0,72616.0,52284.0,38409.0,74525.0,42344.0,140104,14558,141062,12224,281166,26782,8013,35.5,94.0,8013,24.3,65.0
3930,1582,2348,8014,81898.0,82961.0,,,90586.0,62424.0,27449,2447,28789,1679,56238,4126,8014,48.4,23.0,8014,37.8,18.0
1502,647,855,8015,51092.0,50909.0,,,,33750.0,7356,1459,7403,1018,14759,2477,8015,36.9,11.0,8015,30.6,8.0
168,78,90,8017,52554.0,52609.0,,,,36806.0,811,220,747,179,1558,399,8017,,2.0,8017,,
748,352,396,8019,67710.0,68680.0,28510.0,,,28173.0,4096,515,4092,306,8188,821,8019,38.1,3.0,8019,,
1491,735,756,8021,36652.0,36675.0,,,,30030.0,3320,750,3543,595,6863,1345,8021,34.7,4.0,8021,32.6,3.0
850,354,496,8023,31321.0,31286.0,,13214.0,,24292.0,1581,285,1395,320,2976,605,8023,,2.0,8023,,
1449,587,862,8025,31151.0,31389.0,,13750.0,53194.0,16989.0,1759,271,2125,266,3884,537,8025,,2.0,8025,,
736,385,351,8027,35000.0,35636.0,26833.0,,,,1613,524,1736,413,3349,937,8027,59.5,4.0,8027,,
4716,2086,2630,8029,42452.0,42613.0,,33750.0,36743.0,35710.0,11449,2812,12536,2420,23985,5232,8029,46.3,23.0,8029,35.0,17.0
110299,52215,58084,8031,53637.0,58585.0,33139.0,37257.0,51968.0,38740.0,267697,53725,282385,39310,550082,93035,8031,48.5,264.0,8031,36.2,196.0
398,218,180,8033,31875.0,32057.0,,,,36346.0,899,118,758,87,1657,205,8033,,2.0,8033,,
12110,5653,6457,8035,102964.0,103212.0,109333.0,66442.0,103926.0,92710.0,143468,8170,147150,7231,290618,15401,8035,37.1,75.0,8035,24.0,48.0
4780,2769,2011,8037,72214.0,74237.0,53015.0,54637.0,51943.0,52067.0,22270,5524,20430,4256,42700,9780,8037,28.3,9.0,8037,14.9,5.0
1649,819,830,8039,84963.0,84336.0,105526.0,,,61451.0,10597,1313,10716,1135,21313,2448,8039,47.5,10.0,8039,36.5,7.0
75033,33973,41060,8041,58206.0,61208.0,47271.0,41645.0,60311.0,43176.0,266035,37593,290199,30351,556234,67944,8041,50.3,282.0,8041,35.7,196.0
6272,2828,3444,8043,40423.0,40451.0,,28478.0,,41794.0,14966,2281,16985,1946,31951,4227,8043,56.4,38.0,8043,41.3,28.0
6786,3452,3334,8045,56590.0,58930.0,34639.0,,33686.0,43764.0,20773,7848,21056,6668,41829,14516,8045,43.2,19.0,8045,26.1,11.0
413,188,225,8047,65670.0,66210.0,,,,39643.0,2491,343,2426,292,4917,635,8047,,2.0,8047,,
1543,733,810,8049,63628.0,64840.0,37308.0,,,33506.0,6134,1509,5371,1336,11505,2845,8049,47.5,6.0,8049,38.5,4.0
2509,1163,1346,8051,48071.0,48628.0,,101563.0,,31454.0,6999,1402,6139,1059,13138,2461,8051,24.8,3.0,8051,,
70,34,36,8053,57083.0,57875.0,,,,,356,60,394,64,750,124,8053,,2.0,8053,,
1171,646,525,8055,31715.0,32833.0,,43240.0,,25049.0,2602,584,2728,405,5330,989,8055,59.2,8.0,8055,43.5,6.0
155,71,84,8057,46014.0,46892.0,,,,38750.0,582,122,572,54,1154,176,8057,,2.0,8057,,
46423,20756,25667,8059,70164.0,70920.0,45554.0,68851.0,71856.0,51220.0,240890,28944,253891,22256,494781,51200,8059,43.7,262.0,8059,30.5,179.0
189,68,121,8061,40304.0,40439.0,,,,41563.0,544,115,676,99,1220,214,8061,,2.0,8061,,
1157,444,713,8063,40603.0,41563.0,,,,22462.0,2923,574,3029,542,5952,1116,8063,55.1,6.0,8063,36.0,4.0
833,373,460,8065,45367.0,49688.0,,,,41216.0,3236,742,2684,643,5920,1385,8065,,2.0,8065,,
5432,2273,3159,8067,60278.0,61385.0,28922.0,49663.0,57344.0,52960.0,21982,4645,22642,3415,44624,8060,8067,34.4,19.0,8067,24.6,13.0
42338,19766,22572,8069,59805.0,60557.0,42036.0,36506.0,57875.0,46256.0,139780,17059,145434,13510,285214,30569,8069,39.7,124.0,8069,29.8,92.0
2055,1039,1016,8071,45067.0,45376.0,45069.0,15568.0,39659.0,37436.0,5944,1071,6018,970,11962,2041,8071,46.9,10.0,8071,37.3,8.0
624,223,401,8073,39005.0,39398.0,,25833.0,,31458.0,1416,115,2073,159,3489,274,8073,53.5,4.0,8073,46.9,3.0
3529,1745,1784,8075,42319.0,42475.0,2499.0,,,40699.0,9154,2218,8832,1110,17986,3328,8075,36.4,10.0,8075,30.4,8.0
22545,10438,12107,8077,49322.0,49658.0,39271.0,32689.0,,39535.0,62209,10578,64142,9629,126351,20207,8077,56.1,102.0,8077,42.4,77.0
56,18,38,8079,48125.0,52000.0,,,,45568.0,353,28,325,27,678,55,8079,,2.0,8079,,
1462,703,759,8081,51387.0,51829.0,,,64231.0,32129.0,5485,1268,5327,913,10812,2181,8081,40.0,6.0,8081,37.3,5.0
4550,2193,2357,8083,43553.0,44878.0,,28451.0,,40223.0,9654,2983,10467,2391,20121,5374,8083,40.2,15.0,8083,31.0,12.0
7644,3476,4168,8085,43999.0,44539.0,,,88523.0,34544.0,16045,3781,16771,3816,32816,7597,8085,49.6,28.0,8085,40.3,24.0
3218,1172,2046,8087,48450.0,48826.0,41228.0,30833.0,,46194.0,12045,1757,12343,1744,24388,3501,8087,49.5,16.0,8087,41.2,13.0
4396,2097,2299,8089,32311.0,35986.0,,18904.0,30565.0,24850.0,7592,1415,8057,1311,15649,2726,8089,40.5,11.0,8089,29.3,8.0
355,174,181,8091,61624.0,61984.0,,,,31719.0,1844,395,2086,255,3930,650,8091,,2.0,8091,,
1170,563,607,8093,56969.0,56462.0,,,,36176.0,7209,1208,6891,733,14100,1941,8093,35.8,8.0,8093,25.5,4.0
658,293,365,8095,43639.0,43417.0,,12750.0,,40109.0,1913,309,1816,268,3729,577,8095,53.0,4.0,8095,,
1709,663,1046,8097,71196.0,71372.0,,86250.0,,35000.0,7865,1330,7024,1144,14889,2474,8097,24.1,4.0,8097,,
2264,993,1271,8099,40179.0,40260.0,,,,28214.0,5046,965,5307,732,10353,1697,8099,67.3,10.0,8099,58.6,9.0
31017,14201,16816,8101,41286.0,43348.0,40104.0,34861.0,37931.0,34013.0,66883,10100,73703,6961,140586,17061,8101,49.8,99.0,8101,36.8,74.0
1113,521,592,8103,61842.0,61118.0,,76136.0,,53750.0,3068,361,2880,309,5948,670,8103,,2.0,8103,,
2198,1070,1128,8105,39672.0,38786.0,145610.0,,,35776.0,4698,960,4985,882,9683,1842,8105,29.2,5.0,8105,21.0,3.0
2369,1338,1031,8107,64963.0,66137.0,,,,55217.0,10917,1385,9954,1252,20871,2637,8107,31.5,6.0,8107,24.3,4.0
1450,609,841,8109,33393.0,34086.0,,25500.0,,31250.0,2162,937,2244,871,4406,1808,8109,60.6,4.0,8109,,
100,48,52,8111,36324.0,36379.0,,,,21250.0,264,63,226,53,490,116,8111,,2.0,8111,,
854,398,456,8113,56047.0,55135.0,,,,48750.0,3475,562,3155,453,6630,1015,8113,,2.0,8113,,
335,138,197,8115,44191.0,46350.0,70192.0,,41250.0,30938.0,964,164,1108,99,2072,263,8115,,2.0,8115,,
3949,1928,2021,8117,67983.0,71528.0,,33958.0,2499.0,41211.0,12116,3713,10374,2654,22490,6367,8117,14.8,4.0,8117,21.6,3.0
1728,826,902,8119,62372.0,62444.0,128750.0,,92708.0,42656.0,10383,1275,10200,1245,20583,2520,8119,41.1,11.0,8119,26.4,8.0
466,184,282,8121,45541.0,45131.0,,,,34091.0,2001,259,2092,170,4093,429,8121,,2.0,8121,,
34007,15469,18538,8123,60572.0,62265.0,37281.0,47670.0,70000.0,43558.0,117241,16815,118408,15738,235649,32553,8123,45.7,101.0,8123,35.2,76.0
1451,599,852,8125,43105.0,44702.0,,,,26250.0,4057,678,4550,756,8607,1434,8125,62.5,8.0,8125,40.3,5.0
82743,36089,46654,9001,84233.0,94786.0,46418.0,43980.0,112109.0,47911.0,398180,55567,432919,44703,831099,100270,9001,54.9,571.0,9001,34.5,365.0
104196,46770,57426,9003,66395.0,73333.0,42966.0,26289.0,86310.0,34131.0,390154,34444,430902,26115,821056,60559,9003,62.0,662.0,9003,40.4,439.0
12893,6253,6640,9005,72061.0,72584.0,64050.0,,73963.0,60701.0,84207,7090,88395,5185,172602,12275,9005,62.5,160.0,9005,38.7,99.0
10710,4712,5998,9007,79893.0,81748.0,50864.0,68274.0,105321.0,61407.0,74580,5483,79505,3690,154085,9173,9007,65.7,144.0,9007,44.2,96.0
108533,46592,61941,9009,61640.0,68413.0,38667.0,41711.0,75756.0,36393.0,371693,38036,413529,28371,785222,66407,9009,70.2,718.0,9009,44.9,467.0
25766,11243,14523,9011,66233.0,70299.0,45851.0,54753.0,69488.0,35648.0,117687,9625,127638,6301,245325,15926,9011,68.7,224.0,9011,43.3,142.0
9511,4404,5107,9013,79626.0,80666.0,51968.0,,90176.0,48113.0,69525,4026,72384,2882,141909,6908,9013,62.7,98.0,9013,41.8,65.0
11999,4937,7062,9015,59392.0,60866.0,47056.0,55579.0,50938.0,31520.0,52591,4669,55081,3442,107672,8111,9015,65.0,86.0,9015,47.5,62.0
110365,48069,62296,11001,70848.0,115890.0,40677.0,61985.0,83064.0,61087.0,276285,22198,323314,14813,599599,37011,11001,59.0,351.0,11001,40.6,240.0
22074,9294,12780,10001,54976.0,58299.0,48490.0,34177.0,48917.0,41556.0,71860,7217,81320,5658,153180,12875,10001,79.2,147.0,10001,57.0,105.0
60487,25747,34740,10003,65476.0,71263.0,49681.0,47074.0,94421.0,47696.0,236835,22972,262252,19167,499087,42139,10003,67.3,387.0,10003,50.3,289.0
25754,11078,14676,10005,53751.0,56665.0,36482.0,37411.0,97607.0,38682.0,87643,11295,96771,8798,184414,20093,10005,74.2,239.0,10005,53.1,171.0
58203,27526,30677,12001,43073.0,50142.0,26561.0,31900.0,47236.0,32105.0,103064,18026,114762,15667,217826,33693,12001,67.8,160.0,12001,48.6,114.0
4393,1849,2544,12003,47121.0,51751.0,30553.0,,,100647.0,10298,1772,11081,1480,21379,3252,12003,99.5,27.0,12003,75.2,21.0
26235,11556,14679,12005,47368.0,49175.0,33759.0,27721.0,42727.0,42029.0,68041,15563,74296,13119,142337,28682,12005,88.4,185.0,12005,66.5,139.0
4896,2208,2688,12007,41606.0,48213.0,23355.0,,,53889.0,9447,2538,10148,1770,19595,4308,12007,82.1,28.0,12007,65.8,23.0
76460,35131,41329,12009,48925.0,50714.0,33027.0,54879.0,55728.0,42464.0,223646,43920,244237,36499,467883,80419,12009,74.2,647.0,12009,55.4,487.0
265880,119303,146577,12011,51968.0,56399.0,42020.0,41408.0,63451.0,51620.0,701051,186805,768123,176118,1469174,362923,12011,53.5,1129.0,12011,38.7,827.0
2407,1034,1373,12013,34510.0,35000.0,30000.0,55139.0,61750.0,,4924,1212,5067,1382,9991,2594,12013,78.2,15.0,12013,68.4,13.0
19760,8772,10988,12015,44244.0,45107.0,32725.0,16429.0,48750.0,27344.0,65469,12778,72012,12279,137481,25057,12015,62.3,233.0,12015,45.3,175.0
23903,10602,13301,12017,38312.0,38237.0,35171.0,34583.0,74141.0,33650.0,56990,9243,62626,8906,119616,18149,12017,79.7,244.0,12017,64.2,200.0
20580,9158,11422,12019,58290.0,59727.0,50825.0,55192.0,64081.0,58520.0,81814,12802,87934,11830,169748,24632,12019,79.2,161.0,12019,58.5,117.0
47436,22674,24762,12021,57452.0,59387.0,32252.0,47364.0,60750.0,40708.0,129514,37119,141173,31428,270687,68547,12021,43.3,268.0,12021,30.5,194.0
12498,5458,7040,12023,41926.0,44156.0,29569.0,34375.0,93750.0,40239.0,25684,4960,27284,5238,52968,10198,12023,88.2,77.0,12023,62.8,54.0
10123,5668,4455,12027,35165.0,36579.0,22205.0,22188.0,,28697.0,12016,6079,12514,2527,24530,8606,12027,57.7,28.0,12027,45.0,22.0
3061,1320,1741,12029,36292.0,36789.0,21667.0,,,,5773,1510,5975,1316,11748,2826,12029,100.0,26.0,12029,73.8,19.0
150792,66314,84478,12031,47690.0,54477.0,33145.0,45795.0,68057.0,41265.0,348726,69632,393413,61083,742139,130715,12031,78.1,685.0,12031,53.8,465.0
45308,20987,24321,12033,45390.0,50794.0,30842.0,56161.0,40284.0,36743.0,116879,22448,132565,18328,249444,40776,12033,78.4,281.0,12033,58.8,211.0
14814,6979,7835,12035,47866.0,49324.0,35800.0,,63291.0,47200.0,40356,7640,45070,7344,85426,14984,12035,67.7,120.0,12035,49.7,90.0
1977,872,1105,12037,40401.0,40464.0,36917.0,27083.0,51917.0,51250.0,3898,1082,3899,903,7797,1985,12037,93.4,16.0,12037,77.7,12.0
11907,5937,5970,12039,35567.0,48910.0,29784.0,,32924.0,29792.0,16381,4465,19672,3451,36053,7916,12039,66.4,38.0,12039,51.5,29.0
3598,1705,1893,12041,40623.0,40690.0,23750.0,23594.0,,,6212,1652,6150,1794,12362,3446,12041,74.3,17.0,12041,71.7,17.0
2408,1150,1258,12043,34877.0,34834.0,22841.0,85515.0,,36563.0,4492,1533,4683,1214,9175,2747,12043,54.9,13.0,12043,41.5,9.0
1924,830,1094,12045,41788.0,44034.0,31556.0,,,29773.0,5660,1346,5374,1079,11034,2425,12045,92.6,20.0,12045,65.2,14.0
3234,1467,1767,12047,35048.0,40971.0,20941.0,,,17292.0,4472,903,4844,828,9316,1731,12047,67.8,12.0,12047,53.2,9.0
7029,3262,3767,12049,35457.0,37104.0,26900.0,,,30239.0,9773,3558,9673,2790,19446,6348,12049,69.0,20.0,12049,49.1,14.0
9696,4898,4798,12051,36771.0,40931.0,22298.0,27625.0,46042.0,34684.0,12624,6343,12932,4928,25556,11271,12051,65.2,25.0,12051,47.8,18.0
27375,12662,14713,12053,40945.0,41559.0,26583.0,25139.0,44187.0,41056.0,69276,13919,77784,11982,147060,25901,12053,74.9,241.0,12053,55.8,183.0
18863,9056,9807,12055,35093.0,36108.0,26045.0,8839.0,89583.0,26814.0,39100,8307,42730,7146,81830,15453,12055,73.3,155.0,12055,51.4,110.0
217684,98476,119208,12057,50579.0,54914.0,34587.0,50721.0,71675.0,39548.0,513975,113535,566133,97187,1080108,210722,12057,69.7,895.0,12057,48.3,616.0
4903,2374,2529,12059,35020.0,35287.0,28750.0,,,10300.0,6781,1939,7454,1544,14235,3483,12059,71.2,20.0,12059,68.6,18.0
20272,8950,11322,12061,45798.0,47439.0,26746.0,,86410.0,35382.0,55362,12465,62107,11598,117469,24063,12061,67.0,180.0,12061,51.2,143.0
9090,4056,5034,12063,35098.0,38721.0,24740.0,31528.0,,26071.0,17614,2648,18268,2817,35882,5465,12063,48.4,31.0,12063,52.8,34.0
1862,741,1121,12065,43355.0,54559.0,23821.0,,,,4579,594,5855,714,10434,1308,12065,42.5,9.0,12065,44.8,9.0
1425,563,862,12067,35864.0,40250.0,31657.0,,,12071.0,2563,950,2877,624,5440,1574,12067,97.3,9.0,12067,78.3,7.0
42497,19644,22853,12069,46403.0,47413.0,38742.0,34604.0,77563.0,42081.0,125259,22303,138043,21490,263302,43793,12069,76.0,400.0,12069,52.9,279.0
105166,48604,56562,12071,48537.0,50195.0,34157.0,34750.0,47389.0,36948.0,255054,66636,280570,55914,535624,122550,12071,59.2,651.0,12071,39.9,441.0
60286,28018,32268,12073,46745.0,56324.0,31270.0,27386.0,52020.0,38282.0,115325,17626,131496,15063,246821,32689,12073,54.8,130.0,12073,42.0,98.0
8601,4159,4442,12075,35782.0,36778.0,30750.0,,14250.0,29163.0,15211,4276,16052,3841,31263,8117,12075,103.5,67.0,12075,77.3,49.0
1237,711,526,12077,39406.0,42766.0,26205.0,,,38421.0,2740,935,2544,555,5284,1490,12077,73.3,6.0,12077,84.1,7.0
4269,1989,2280,12079,32164.0,38690.0,22361.0,,,60625.0,6335,1640,7137,1571,13472,3211,12079,54.8,14.0,12079,55.0,14.0
51595,23144,28451,12081,49675.0,51590.0,35425.0,53750.0,61650.0,34849.0,133634,30738,149647,26970,283281,57708,12081,59.0,328.0,12081,41.7,236.0
60207,26829,33378,12083,39459.0,40756.0,30245.0,,52821.0,30966.0,128783,29261,144671,26132,273454,55393,12083,82.0,493.0,12083,56.6,347.0
17965,8725,9240,12085,51593.0,53535.0,30564.0,45200.0,69009.0,37871.0,60203,12641,67195,8716,127398,21357,12085,59.6,177.0,12085,40.5,124.0
530006,234079,295927,12086,43129.0,45586.0,33103.0,42237.0,61134.0,40499.0,913720,345984,1029301,323198,1943021,669182,12086,44.4,1310.0,12086,29.9,885.0
9998,4952,5046,12087,57290.0,59105.0,46275.0,,75192.0,43500.0,29681,9093,27902,7520,57583,16613,12087,54.6,62.0,12087,45.5,50.0
9652,4524,5128,12089,54116.0,55071.0,33250.0,,64871.0,53914.0,30711,6234,33052,5141,63763,11375,12089,81.2,83.0,12089,57.3,57.0
24595,11057,13538,12091,55880.0,58718.0,38208.0,62670.0,48704.0,46217.0,73497,13973,81113,12515,154610,26488,12091,71.8,153.0,12091,57.1,121.0
9965,4747,5218,12093,35405.0,35678.0,28317.0,,51146.0,33452.0,13706,4583,14278,3667,27984,8250,12093,93.3,48.0,12093,69.3,36.0
212489,96829,115660,12095,47943.0,52068.0,36066.0,32356.0,57443.0,39062.0,467393,128157,507628,114016,975021,242173,12095,57.6,588.0,12095,42.1,424.0
58146,26746,31400,12097,44254.0,45851.0,39627.0,43355.0,52118.0,37150.0,112065,34689,121293,30788,233358,65477,12097,54.7,147.0,12097,38.1,102.0
197340,88523,108817,12099,53363.0,56882.0,37601.0,45833.0,71473.0,42396.0,529441,128224,596926,111457,1126367,239681,12099,54.1,1183.0,12099,37.3,852.0
66144,29154,36990,12101,45064.0,44730.0,45550.0,38239.0,70052.0,46505.0,193843,35107,212253,32228,406096,67335,12101,75.9,552.0,12101,57.3,422.0
131643,58929,72714,12103,45819.0,47546.0,30695.0,43138.0,57230.0,36633.0,365646,75277,414317,64993,779963,140270,12103,68.9,1032.0,12103,50.6,777.0
111877,50847,61030,12105,43162.0,45438.0,31997.0,45735.0,62432.0,38347.0,244527,54900,269368,48305,513895,103205,12105,74.4,631.0,12105,50.1,423.0
20397,9041,11356,12107,31715.0,34038.0,20512.0,21821.0,,28316.0,26738,8046,29921,6747,56659,14793,12107,97.2,106.0,12107,71.1,78.0
19706,8625,11081,12109,66194.0,67032.0,42171.0,76563.0,116250.0,50146.0,89166,11914,97157,10407,186323,22321,12109,65.2,166.0,12109,42.3,107.0
52201,24225,27976,12111,43459.0,46015.0,30826.0,38885.0,64583.0,37262.0,111403,27579,121141,25709,232544,53288,12111,64.5,277.0,12111,48.9,213.0
19063,8482,10581,12113,58923.0,60549.0,46517.0,25278.0,62351.0,47892.0,63955,10401,68241,9510,132196,19911,12113,74.9,130.0,12113,61.6,104.0
42386,19475,22911,12115,51766.0,52680.0,31037.0,34410.0,58659.0,43207.0,156083,29291,177734,25125,333817,54416,12115,57.6,479.0,12115,41.9,366.0
52637,24575,28062,12117,57010.0,60254.0,38754.0,46875.0,70719.0,42922.0,175304,34653,193878,30781,369182,65434,12117,54.2,246.0,12117,41.5,187.0
10802,4602,6200,12119,50350.0,51247.0,23750.0,53350.0,,31006.0,42824,4040,47895,4641,90719,8681,12119,65.3,180.0,12119,43.1,110.0
10012,4500,5512,12121,36289.0,38041.0,23000.0,,,23333.0,16064,4338,18457,3256,34521,7594,12121,87.2,53.0,12121,67.9,42.0
2720,1226,1494,12123,36181.0,38511.0,29341.0,17067.0,,41659.0,7353,1417,8621,1209,15974,2626,12123,84.4,25.0,12123,66.8,20.0
2002,814,1188,12125,39163.0,40244.0,28516.0,86071.0,,,4013,645,4612,749,8625,1394,12125,203.7,35.0,12125,113.5,19.0
85881,39086,46795,12127,41117.0,43139.0,25982.0,31767.0,50705.0,34411.0,195665,46346,218308,37655,413973,84001,12127,70.8,568.0,12127,54.1,439.0
4101,1658,2443,12129,50340.0,49726.0,55511.0,,,,11867,1904,12202,1544,24069,3448,12129,95.9,31.0,12129,76.3,24.0
9804,5087,4717,12131,44966.0,46422.0,27813.0,,66528.0,43370.0,22001,6235,24485,4684,46486,10919,12131,74.3,57.0,12131,54.4,41.0
4723,2407,2316,12133,38970.0,40368.0,28095.0,,,,9143,1767,9808,1333,18951,3100,12133,74.7,23.0,12133,67.5,21.0
3745,1485,2260,13001,37135.0,39981.0,26130.0,,,30907.0,6884,1813,7352,1904,14236,3717,13001,74.4,15.0,13001,56.3,12.0
2370,1068,1302,13003,30933.0,34130.0,24598.0,,,24009.0,2825,1239,2946,1258,5771,2497,13003,59.4,5.0,13003,75.8,6.0
1919,850,1069,13005,37162.0,42561.0,20302.0,,34706.0,42802.0,4042,1127,4639,893,8681,2020,13005,87.5,11.0,13005,66.5,8.0
752,287,465,13007,44297.0,51538.0,26806.0,,,,1242,337,1360,353,2602,690,13007,72.9,3.0,13007,,
13201,5601,7600,13009,32460.0,39592.0,22906.0,,39524.0,,17553,3212,20229,2532,37782,5744,13009,73.5,36.0,13009,47.3,23.0
3026,1497,1529,13011,41472.0,41609.0,34342.0,,36146.0,29375.0,7764,1546,7383,1626,15147,3172,13011,65.2,13.0,13011,33.8,7.0
10902,5099,5803,13013,52012.0,53176.0,38643.0,,69886.0,41034.0,29308,6640,29988,5862,59296,12502,13013,89.6,55.0,13013,63.4,37.0
15819,6659,9160,13015,48893.0,51065.0,37979.0,56190.0,56094.0,33259.0,40864,8691,42129,8803,82993,17494,13015,91.3,91.0,13015,63.2,61.0
6024,2511,3513,13017,29994.0,38830.0,18397.0,,,26005.0,6364,1800,7307,1686,13671,3486,13017,84.0,18.0,13017,65.1,13.0
4923,2088,2835,13019,31835.0,34538.0,26063.0,,,29643.0,6868,2398,7046,2399,13914,4797,13019,78.2,18.0,13019,54.4,12.0
40611,16798,23813,13021,36519.0,52978.0,25620.0,,62300.0,27026.0,57314,12905,68408,12534,125722,25439,13021,79.4,134.0,13021,59.1,99.0
2616,1270,1346,13023,38991.0,46932.0,17738.0,,,,5107,829,5784,661,10891,1490,13023,72.3,11.0,13023,60.1,9.0
3812,1561,2251,13025,37206.0,37212.0,29861.0,,,,6714,2402,6844,2433,13558,4835,13025,87.8,18.0,13025,74.1,15.0
4265,1864,2401,13027,32663.0,41641.0,19521.0,,,16801.0,5831,1825,6442,1500,12273,3325,13027,76.9,16.0,13027,51.1,11.0
4487,1939,2548,13029,63327.0,64884.0,54306.0,,37857.0,60219.0,13252,2139,14659,2148,27911,4287,13029,84.3,22.0,13029,68.1,17.0
21794,10148,11646,13031,36032.0,41190.0,25995.0,,48967.0,28125.0,29523,5724,30317,5977,59840,11701,13031,78.6,44.0,13031,56.8,32.0
7131,3099,4032,13033,33641.0,49398.0,19626.0,,48438.0,31736.0,8811,2074,9966,1911,18777,3985,13033,85.9,21.0,13033,51.6,13.0
4329,2023,2306,13035,41667.0,50384.0,30746.0,,,124485.0,8376,1778,9064,1781,17440,3559,13035,95.7,25.0,13035,81.3,20.0
1924,891,1033,13037,25513.0,40486.0,21366.0,,,,1590,514,2045,524,3635,1038,13037,63.4,4.0,13037,50.2,4.0
6365,2795,3570,13039,52473.0,58940.0,38130.0,40250.0,87538.0,63529.0,19948,3210,21611,3033,41559,6243,13039,67.4,29.0,13039,49.3,21.0
3398,1480,1918,13043,30185.0,34518.0,22307.0,,,,3697,1481,4227,1339,7924,2820,13043,82.9,11.0,13043,62.1,8.0
22441,9360,13081,13045,43586.0,46792.0,32268.0,,30882.0,27139.0,44101,9868,48004,9459,92105,19327,13045,83.9,88.0,13045,59.0,62.0
8061,3588,4473,13047,50876.0,50819.0,49981.0,,55652.0,46985.0,26625,4978,29051,4201,55676,9179,13047,65.6,50.0,13047,49.1,37.0
2010,1140,870,13049,42778.0,41929.0,46875.0,,,46316.0,4584,1208,4690,1299,9274,2507,13049,60.0,9.0,13049,49.4,7.0
50980,21510,29470,13051,47218.0,55466.0,34807.0,,51606.0,41630.0,104174,23951,119106,24088,223280,48039,13051,65.2,183.0,13051,44.4,126.0
960,569,391,13053,43378.0,44877.0,36895.0,,,39677.0,3063,521,3390,255,6453,776,13053,84.3,3.0,13053,,
5488,2243,3245,13055,32913.0,33927.0,22219.0,,,38750.0,9063,2149,10018,2139,19081,4288,13055,101.5,31.0,13055,74.5,23.0
24273,11323,12950,13057,68926.0,70839.0,67347.0,,61196.0,41363.0,93307,17236,99818,14680,193125,31916,13057,73.2,135.0,13057,46.7,84.0
40559,18801,21758,13059,32162.0,37856.0,24395.0,,33598.0,27375.0,46322,10381,53847,9368,100169,19749,13059,61.8,52.0,13059,41.6,36.0
1285,579,706,13061,20438.0,41359.0,14797.0,,,,1022,463,1258,303,2280,766,13061,64.1,3.0,13061,,
65787,29093,36694,13063,40938.0,38499.0,41967.0,25700.0,41626.0,34582.0,91148,33348,106904,32596,198052,65944,13063,65.1,115.0,13063,45.5,79.0
2339,915,1424,13065,24015.0,36016.0,12905.0,,,2499.0,2631,644,2665,720,5296,1364,13065,86.9,7.0,13065,56.0,4.0
87880,40060,47820,13067,65873.0,75041.0,50341.0,34120.0,84976.0,42816.0,283287,61679,312433,56631,595720,118310,13067,60.3,341.0,13067,40.3,223.0
9975,4089,5886,13069,33965.0,37395.0,23251.0,35083.0,45466.0,26505.0,14017,4585,16269,4704,30286,9289,13069,79.5,34.0,13069,59.9,25.0
12086,5622,6464,13071,32409.0,38286.0,22201.0,38482.0,,31474.0,15045,7292,17560,5434,32605,12726,13071,89.5,44.0,13071,62.0,30.0
12517,5247,7270,13073,71021.0,72414.0,62171.0,,87164.0,52962.0,57173,6985,62660,6391,119833,13376,13073,61.4,73.0,13073,43.8,53.0
4244,1837,2407,13075,35683.0,41234.0,26307.0,38571.0,,30956.0,6130,2021,6425,2313,12555,4334,13075,90.0,17.0,13075,60.5,12.0
17489,7061,10428,13077,62461.0,66660.0,40190.0,250001.0,68958.0,38823.0,56787,8063,60351,7622,117138,15685,13077,65.0,78.0,13077,47.4,57.0
2122,984,1138,13079,41825.0,44298.0,28682.0,,,,5257,1072,5226,836,10483,1908,13079,100.7,16.0,13079,65.9,9.0
7468,3161,4307,13081,31615.0,47089.0,17637.0,,,52893.0,8719,1980,9882,2284,18601,4264,13081,72.3,21.0,13081,59.2,17.0
2300,986,1314,13083,46434.0,47377.0,,,,,6555,1335,7142,1264,13697,2599,13083,79.7,17.0,13083,79.3,16.0
3156,1372,1784,13085,56943.0,57078.0,,,,42721.0,9301,1797,9935,1457,19236,3254,13085,74.1,21.0,13085,61.8,16.0
7418,3071,4347,13087,31284.0,38125.0,22021.0,55417.0,,50427.0,9471,2732,11253,2606,20724,5338,13087,70.4,23.0,13087,58.2,19.0
135469,61067,74402,13089,51376.0,73219.0,42048.0,41875.0,53266.0,36789.0,266420,70503,307491,64529,573911,135032,13089,53.2,311.0,13089,37.8,216.0
4279,2065,2214,13091,34271.0,41636.0,26994.0,,,17806.0,7503,1809,8548,1351,16051,3160,13091,81.3,20.0,13091,53.6,13.0
3673,1729,1944,13093,28696.0,30847.0,22813.0,,,38223.0,4541,1544,5394,1140,9935,2684,13093,58.6,10.0,13093,29.8,5.0
27557,11753,15804,13095,32084.0,50469.0,26399.0,,,34063.0,32319,9804,40211,9197,72530,19001,13095,73.4,72.0,13095,60.9,59.0
22118,9856,12262,13097,53881.0,56579.0,49904.0,33500.0,64697.0,47247.0,53134,11539,59541,11129,112675,22668,13097,81.1,90.0,13097,55.0,59.0
2916,1293,1623,13099,31680.0,44729.0,20277.0,,,2499.0,3871,934,4701,914,8572,1848,13099,61.5,9.0,13099,60.1,8.0
1170,436,734,13101,32959.0,34337.0,,,,23459.0,1259,634,1488,667,2747,1301,13101,,2.0,13101,,
5749,2473,3276,13103,63100.0,67761.0,40513.0,,82661.0,62769.0,22974,3773,22833,4476,45807,8249,13103,85.2,41.0,13103,65.8,29.0
3664,1459,2205,13105,35388.0,41173.0,20120.0,,,39097.0,7653,1521,8694,1435,16347,2956,13105,73.4,20.0,13105,56.0,15.0
6700,3151,3549,13107,32229.0,38174.0,23941.0,,2499.0,37156.0,7750,2841,9203,2169,16953,5010,13107,67.6,18.0,13107,59.3,16.0
2857,1127,1730,13109,37865.0,42868.0,31389.0,,,22131.0,3903,817,4597,1013,8500,1830,13109,68.8,9.0,13109,54.8,7.0
5404,2047,3357,13111,37049.0,37117.0,,80192.0,,33889.0,9310,2140,10093,2040,19403,4180,13111,73.2,29.0,13111,46.6,20.0
9129,3883,5246,13113,79066.0,78589.0,80639.0,65714.0,78424.0,51544.0,47425,4750,50925,4698,98350,9448,13113,47.4,57.0,13113,34.1,40.0
19605,9048,10557,13115,41549.0,46211.0,26090.0,,48675.0,31492.0,36663,8536,40916,7882,77579,16418,13115,81.1,92.0,13115,55.5,63.0
13547,5932,7615,13117,88816.0,87872.0,74545.0,80913.0,117064.0,49496.0,85640,11472,87649,10870,173289,22342,13117,60.6,90.0,13117,35.0,51.0
5122,2253,2869,13119,33816.0,35323.0,23000.0,,,26964.0,8671,2036,9360,1836,18031,3872,13119,81.4,25.0,13119,64.5,19.0
167391,72577,94814,13121,57207.0,84666.0,36030.0,32048.0,93780.0,43655.0,395438,75916,432816,71007,828254,146923,13121,54.5,431.0,13121,38.3,298.0
6664,3541,3123,13123,40228.0,40731.0,,148125.0,151250.0,27931.0,10809,3588,11237,2791,22046,6379,13123,76.1,32.0,13123,39.1,16.0
483,237,246,13125,40759.0,44875.0,19514.0,,,,1233,242,1243,274,2476,516,13125,,2.0,13125,,
14981,6339,8642,13127,45918.0,55254.0,26347.0,26397.0,40769.0,47688.0,30774,7351,35063,7594,65837,14945,13127,71.9,73.0,13127,50.9,51.0
11188,5321,5867,13129,41612.0,42847.0,25995.0,,52500.0,32918.0,21972,5414,22625,5339,44597,10753,13129,94.7,55.0,13129,74.1,43.0
7648,3529,4119,13131,34187.0,41419.0,19654.0,,,17961.0,9315,3037,9964,2735,19279,5772,13131,74.0,23.0,13131,64.5,19.0
4033,1870,2163,13133,42408.0,57795.0,22827.0,,49044.0,20473.0,6205,1667,6972,1310,13177,2977,13133,69.9,19.0,13133,37.3,10.0
117553,54558,62995,13135,60289.0,69649.0,52203.0,47143.0,57135.0,38924.0,330105,87272,355186,81567,685291,168839,13135,51.8,288.0,13135,37.3,200.0
7220,3357,3863,13137,40907.0,41470.0,30000.0,58750.0,44028.0,34929.0,16605,3957,16796,3866,33401,7823,13137,64.4,35.0,13137,49.3,27.0
34120,16393,17727,13139,51202.0,53476.0,33260.0,,53400.0,39501.0,73737,19196,76493,17175,150230,36371,13139,61.2,108.0,13139,45.6,81.0
2113,835,1278,13141,24925.0,37994.0,22083.0,,,,2620,447,3321,625,5941,1072,13141,38.8,5.0,13141,41.6,5.0
5724,2583,3141,13143,41910.0,42532.0,32054.0,2499.0,36429.0,,11440,2323,12250,2189,23690,4512,13143,94.4,33.0,13143,76.0,26.0
2991,1317,1674,13145,63824.0,74078.0,31464.0,,95139.0,103902.0,13962,1999,14769,1625,28731,3624,13145,62.0,24.0,13145,45.8,17.0
5403,2421,2982,13147,37653.0,39567.0,24020.0,,,35610.0,9591,2477,10690,1905,20281,4382,13147,69.0,25.0,13147,51.1,19.0
2349,1048,1301,13149,41525.0,42512.0,29650.0,13750.0,,18542.0,4696,946,4900,932,9596,1878,13149,104.6,15.0,13149,64.6,9.0
27162,11870,15292,13151,60424.0,62010.0,58448.0,,72840.0,46703.0,85371,14877,94784,15133,180155,30010,13151,60.3,102.0,13151,46.7,74.0
25111,10623,14488,13153,53270.0,58985.0,41191.0,28500.0,52375.0,53719.0,58947,10117,65869,9306,124816,19423,13153,73.2,96.0,13153,56.4,72.0
2300,1081,1219,13155,34156.0,42619.0,22332.0,,,,3483,913,3663,807,7146,1720,13155,83.4,10.0,13155,68.5,8.0
8314,3770,4544,13157,53379.0,54911.0,31625.0,47974.0,58750.0,47549.0,25164,4923,26283,4530,51447,9453,13157,78.4,50.0,13157,62.1,37.0
2785,1269,1516,13159,42368.0,43550.0,38393.0,,,,5250,1356,5831,1056,11081,2412,13159,78.7,12.0,13159,45.2,7.0
3309,1383,1926,13161,36385.0,37822.0,20357.0,,,29866.0,5847,1475,5753,1799,11600,3274,13161,76.2,13.0,13161,74.9,13.0
4889,2228,2661,13163,26557.0,41547.0,17467.0,55833.0,,15608.0,5460,2074,6623,1709,12083,3783,13163,62.8,14.0,13163,68.8,14.0
2984,1335,1649,13165,24604.0,29552.0,19763.0,,,,3388,1032,3609,811,6997,1843,13165,68.6,7.0,13165,60.0,6.0
2125,1064,1061,13167,34438.0,40158.0,16637.0,,,,4053,936,3524,722,7577,1658,13167,65.4,8.0,13167,53.9,7.0
4770,2119,2651,13169,51857.0,56293.0,38529.0,,,86806.0,11697,2189,12775,1798,24472,3987,13169,79.9,27.0,13169,56.7,18.0
3713,1794,1919,13171,40344.0,47421.0,20448.0,,,36146.0,6918,1516,7795,1609,14713,3125,13171,86.5,18.0,13171,70.7,15.0
2675,1226,1449,13173,37605.0,44768.0,16422.0,,,36625.0,3545,1171,4178,968,7723,2139,13173,77.2,8.0,13173,63.3,6.0
12823,5604,7219,13175,32356.0,38798.0,20954.0,,,37019.0,18632,3499,21023,3685,39655,7184,13175,69.5,41.0,13175,54.6,32.0
3417,1356,2061,13177,61537.0,64484.0,51638.0,,50833.0,,11578,1659,12983,1398,24561,3057,13177,83.2,19.0,13177,62.2,14.0
11047,4963,6084,13179,42201.0,44140.0,40170.0,35694.0,45833.0,43938.0,22886,4140,27203,3953,50089,8093,13179,76.8,30.0,13179,46.7,18.0
1912,799,1113,13181,34243.0,36931.0,27500.0,,,,3005,613,3339,676,6344,1289,13181,65.3,7.0,13181,54.5,6.0
2936,1244,1692,13183,48863.0,51000.0,41222.0,18813.0,,29259.0,5944,1405,7095,1139,13039,2544,13183,88.9,10.0,13183,60.6,7.0
28907,13270,15637,13185,36834.0,45193.0,24116.0,103971.0,29704.0,27230.0,40735,10962,46699,10123,87434,21085,13185,65.3,62.0,13185,52.8,49.0
5559,2398,3161,13187,43804.0,44625.0,,,,43571.0,12100,2752,13756,1907,25856,4659,13187,72.3,24.0,13187,50.0,16.0
5410,2397,3013,13189,36656.0,50554.0,22130.0,,,17679.0,8135,1936,9121,2099,17256,4035,13189,69.5,18.0,13189,57.6,14.0
2956,1296,1660,13191,42988.0,50587.0,27511.0,,,55948.0,5469,1281,6025,1132,11494,2413,13191,55.0,11.0,13191,39.5,8.0
3639,1541,2098,13193,28684.0,41875.0,17660.0,,56645.0,,4552,1488,5046,1199,9598,2687,13193,69.0,11.0,13193,55.9,9.0
4798,2176,2622,13195,41912.0,42850.0,30750.0,45750.0,,28886.0,11295,2515,12103,2143,23398,4658,13195,90.4,31.0,13195,70.8,23.0
1836,640,1196,13197,36242.0,39266.0,26210.0,,,223750.0,3072,1249,3655,663,6727,1912,13197,64.6,7.0,13197,56.7,6.0
4733,2135,2598,13199,35832.0,44852.0,24829.0,,,,8287,1832,9123,1925,17410,3757,13199,66.8,19.0,13199,54.0,15.0
1608,648,960,13201,33983.0,42076.0,17279.0,,,,2210,518,2575,471,4785,989,13201,89.1,8.0,13201,64.8,6.0
5905,2385,3520,13205,31915.0,39833.0,25763.0,,,28929.0,7804,2078,8547,2342,16351,4420,13205,85.1,23.0,13205,56.2,15.0
3492,1480,2012,13207,48744.0,54655.0,22596.0,,,58958.0,10708,1782,11425,1731,22133,3513,13207,72.7,24.0,13207,41.0,13.0
2076,979,1097,13209,34672.0,38542.0,25243.0,,,36250.0,3344,832,3630,785,6974,1617,13209,71.7,7.0,13209,66.8,6.0
2529,1047,1482,13211,51820.0,58421.0,32572.0,,,,7275,1122,7953,1354,15228,2476,13211,65.5,16.0,13211,49.2,11.0
7765,3685,4080,13213,35539.0,35208.0,,,,48656.0,14877,4265,16243,3793,31120,8058,13213,103.1,42.0,13213,69.7,28.0
38921,16697,22224,13215,42306.0,53668.0,32351.0,61741.0,62361.0,39164.0,71343,14830,87018,13855,158361,28685,13215,70.3,134.0,13215,51.7,99.0
17281,7478,9803,13217,49179.0,51827.0,46070.0,31875.0,62557.0,41530.0,40481,7653,45244,8348,85725,16001,13217,78.9,69.0,13217,59.5,51.0
2487,1084,1403,13219,72182.0,73102.0,42399.0,250001.0,130643.0,50724.0,14971,1716,15812,1701,30783,3417,13219,46.8,15.0,13219,34.3,11.0
2316,1054,1262,13221,44226.0,49177.0,24881.0,,,40464.0,6078,1142,6369,957,12447,2099,13221,75.4,14.0,13221,44.5,8.0
18445,7439,11006,13223,60109.0,60992.0,57598.0,60068.0,48077.0,52163.0,61605,10000,65284,9849,126889,19849,13223,77.7,83.0,13223,51.9,51.0
5471,2439,3032,13225,41588.0,54362.0,32062.0,,,26215.0,10354,2667,11558,2377,21912,5044,13225,77.9,22.0,13225,71.9,20.0
3418,1479,1939,13227,54123.0,54863.0,,,,,12454,2293,12939,1782,25393,4075,13227,82.3,34.0,13227,54.0,22.0
4455,2269,2186,13229,40247.0,43400.0,15809.0,,,34655.0,7350,1945,7718,1777,15068,3722,13229,80.1,18.0,13229,70.5,16.0
2132,1008,1124,13231,51338.0,53792.0,32500.0,,,,7234,1444,7439,1428,14673,2872,13231,75.6,15.0,13231,62.9,12.0
8767,3831,4936,13233,37853.0,39732.0,28987.0,,37756.0,51033.0,15636,4410,17711,3149,33347,7559,13233,102.0,48.0,13233,77.5,37.0
1929,655,1274,13235,38750.0,46435.0,22250.0,,,26208.0,3916,858,4421,852,8337,1710,13235,50.6,8.0,13235,37.8,6.0
3446,1912,1534,13237,44299.0,54436.0,32725.0,,,27053.0,8179,2278,9375,1249,17554,3527,13237,74.4,23.0,13237,55.9,17.0
558,208,350,13239,31487.0,32069.0,27049.0,,,,855,251,1046,174,1901,425,13239,110.8,5.0,13239,87.2,4.0
3458,1544,1914,13241,35211.0,37178.0,,,,,5685,2167,6431,1784,12116,3951,13241,67.1,18.0,13241,46.3,13.0
2145,1079,1066,13243,28377.0,45208.0,22054.0,,,,2791,888,2898,620,5689,1508,13243,56.6,6.0,13243,40.9,5.0
48498,20943,27555,13245,37424.0,46154.0,31130.0,34861.0,42050.0,43258.0,73605,15946,86184,15914,159789,31860,13245,72.7,148.0,13245,56.8,113.0
14155,6535,7620,13247,50455.0,50519.0,50814.0,,54375.0,34393.0,32871,7965,36981,8361,69852,16326,13247,60.7,49.0,13247,40.3,32.0
1187,512,675,13249,39375.0,48864.0,20117.0,,,,1907,610,2016,541,3923,1151,13249,69.9,4.0,13249,,
3482,1551,1931,13251,34466.0,42857.0,22873.0,,,,5274,1358,5852,1327,11126,2685,13251,79.1,15.0,13251,57.0,10.0
1595,594,1001,13253,34905.0,42863.0,21538.0,,,34398.0,3165,893,3756,849,6921,1742,13253,66.4,9.0,13253,38.8,5.0
14238,5975,8263,13255,40246.0,48097.0,24870.0,42885.0,36299.0,33025.0,24186,5838,28153,4617,52339,10455,13255,74.3,55.0,13255,52.2,38.0
4707,2468,2239,13257,40315.0,42979.0,23784.0,,,,10161,2186,11520,1748,21681,3934,13257,76.8,27.0,13257,63.1,22.0
1645,693,952,13259,21118.0,45833.0,15295.0,,,,1401,648,1860,389,3261,1037,13259,65.5,4.0,13259,65.0,4.0
9741,4124,5617,13261,32758.0,46492.0,22610.0,,33952.0,22284.0,11738,2388,13950,2450,25688,4838,13261,63.1,22.0,13261,48.6,17.0
1291,630,661,13263,34078.0,40513.0,25156.0,,,62083.0,2635,485,2787,563,5422,1048,13263,73.2,7.0,13263,61.4,5.0
511,195,316,13265,26306.0,33417.0,23531.0,,,,620,209,748,144,1368,353,13265,,2.0,13265,,
5646,2173,3473,13267,33980.0,40830.0,18161.0,,,24150.0,7168,1613,8696,1947,15864,3560,13267,100.8,26.0,13267,79.1,20.0
2351,1041,1310,13269,28143.0,36079.0,20049.0,,,,2958,903,3593,739,6551,1642,13269,54.2,6.0,13269,43.1,5.0
3565,1401,2164,13271,26449.0,30054.0,20500.0,,,29278.0,4484,1276,5636,1127,10120,2403,13271,55.1,11.0,13271,45.6,9.0
3216,1329,1887,13273,28688.0,50152.0,19776.0,,,,3138,942,3922,881,7060,1823,13273,63.0,8.0,13273,53.7,6.0
10335,4943,5392,13275,36641.0,45275.0,24514.0,,50779.0,32552.0,16665,4194,19432,3831,36097,8025,13275,74.5,41.0,13275,60.6,34.0
11372,4841,6531,13277,37653.0,47480.0,23706.0,,,27198.0,14468,4956,16409,4533,30877,9489,13277,71.4,31.0,13277,54.1,23.0
6674,2769,3905,13279,33679.0,41875.0,22629.0,,,28851.0,9405,3180,11303,2984,20708,6164,13279,74.0,23.0,13279,58.6,18.0
1862,817,1045,13281,37000.0,37199.0,,,,,4375,762,4735,764,9110,1526,13281,62.4,15.0,13281,56.5,12.0
1242,491,751,13283,38596.0,45664.0,21974.0,,,,2427,519,2918,501,5345,1020,13283,78.5,6.0,13283,61.0,5.0
14388,5631,8757,13285,41489.0,49748.0,27204.0,,72557.0,51004.0,26673,5391,30199,5172,56872,10563,13285,71.1,52.0,13285,50.6,37.0
2027,1067,960,13287,31806.0,41092.0,24082.0,,,2499.0,2846,1128,3240,770,6086,1898,13287,80.4,9.0,13287,54.9,6.0
2324,976,1348,13289,30468.0,38080.0,20438.0,,,,3447,682,3660,630,7107,1312,13289,91.8,12.0,13289,57.2,7.0
2860,1353,1507,13291,40799.0,40645.0,,,48050.0,56319.0,8616,1695,9628,1331,18244,3026,13291,70.4,30.0,13291,43.5,18.0
6137,2988,3149,13293,35774.0,39387.0,27769.0,,,25136.0,10356,1973,11483,2142,21839,4115,13293,87.8,31.0,13293,56.5,20.0
11818,5435,6383,13295,41632.0,42330.0,30093.0,,,57926.0,27895,4896,28522,5676,56417,10572,13295,84.3,72.0,13295,76.4,65.0
11801,4642,7159,13297,54453.0,57341.0,32407.0,21783.0,82011.0,64000.0,36422,5187,37677,6185,74099,11372,13297,67.9,61.0,13297,53.5,47.0
9686,3807,5879,13299,34909.0,40436.0,24617.0,,,37813.0,12488,3237,14200,3448,26688,6685,13299,70.6,32.0,13299,50.6,22.0
1485,619,866,13301,29176.0,42344.0,19915.0,,,,2094,438,2470,481,4564,919,13301,84.9,7.0,13301,70.4,6.0
4961,2052,2909,13303,37932.0,52253.0,23329.0,,,21477.0,7449,1569,8563,1594,16012,3163,13303,68.2,17.0,13303,49.4,12.0
5633,2316,3317,13305,38955.0,44301.0,22129.0,12212.0,,26875.0,10408,3006,11328,3135,21736,6141,13305,76.2,25.0,13305,59.3,19.0
608,222,386,13307,37063.0,51544.0,30120.0,,,,1238,127,1078,272,2316,399,13307,,2.0,13307,,
1177,404,773,13309,27620.0,30807.0,15475.0,,,,1508,335,1962,544,3470,879,13309,62.8,5.0,13309,51.2,4.0
5195,2364,2831,13311,40888.0,41737.0,32250.0,,,31508.0,11160,2236,11932,2264,23092,4500,13311,69.8,27.0,13311,47.3,17.0
19270,8532,10738,13313,40596.0,41076.0,26577.0,,52188.0,36447.0,39089,11898,40821,10887,79910,22785,13313,77.6,79.0,13313,64.5,64.0
1599,675,924,13315,32043.0,38750.0,21512.0,,,,2808,532,3002,597,5810,1129,13315,64.9,7.0,13315,45.7,5.0
2795,1122,1673,13317,32727.0,43893.0,20518.0,,26705.0,30385.0,3817,797,4416,788,8233,1585,13317,66.0,10.0,13317,57.7,9.0
1640,661,979,13319,38485.0,44931.0,26989.0,,,37813.0,3862,674,4275,476,8137,1150,13319,79.9,11.0,13319,56.9,8.0
4445,1961,2484,13321,37974.0,44709.0,24994.0,,,30688.0,7876,2283,8636,2197,16512,4480,13321,70.8,19.0,13321,51.3,13.0
36756,17957,18799,15001,52108.0,52303.0,50221.0,28003.0,56380.0,41302.0,86553,8577,88674,6523,175227,15100,15001,44.9,107.0,15001,33.3,79.0
92404,41559,50845,15003,74460.0,75175.0,62866.0,50593.0,77807.0,61601.0,429201,26111,457423,20975,886624,47086,15003,48.3,550.0,15003,32.9,377.0
12,5,7,15005,66250.0,,,,,,32,4,35,4,67,8,15005,,2.0,15005,,
7384,3291,4093,15007,65101.0,62964.0,66172.0,78605.0,66174.0,59022.0,31135,3317,32223,2228,63358,5545,15007,45.2,39.0,15007,34.6,30.0
17388,7899,9489,15009,66476.0,62763.0,49893.0,49375.0,74310.0,50297.0,72806,6977,74047,5505,146853,12482,15009,43.2,80.0,15009,28.6,51.0
764,274,490,19001,46526.0,46330.0,,,,,3329,296,3429,233,6758,529,19001,65.2,8.0,19001,42.3,5.0
388,177,211,19003,48043.0,48587.0,,,,,1787,128,1782,125,3569,253,19003,68.9,4.0,19003,,
1491,620,871,19005,45890.0,46212.0,19886.0,,,32863.0,6267,742,6077,667,12344,1409,19005,39.9,9.0,19005,35.3,8.0
1719,749,970,19007,41394.0,41801.0,,,,,5533,706,5627,672,11160,1378,19007,78.5,15.0,19007,56.3,11.0
552,204,348,19009,46979.0,46840.0,,,,,2562,254,2676,227,5238,481,19009,42.4,4.0,19009,,
2440,1215,1225,19011,60606.0,60820.0,,16250.0,,,12198,616,12243,509,24441,1125,19011,67.5,22.0,19011,50.2,17.0
19887,8889,10998,19013,48369.0,51200.0,25471.0,,51528.0,34397.0,59036,5024,62677,4475,121713,9499,19013,72.5,108.0,19013,56.3,84.0
2588,1093,1495,19015,52985.0,52616.0,,,,40938.0,11723,1177,12144,725,23867,1902,19015,61.3,21.0,19015,47.4,17.0
1894,671,1223,19017,62163.0,62058.0,125208.0,,,73500.0,11386,568,11904,318,23290,886,19017,41.6,14.0,19017,31.7,10.0
1970,843,1127,19019,56150.0,56487.0,,,,,9284,996,9578,887,18862,1883,19019,82.8,21.0,19019,56.2,15.0
2452,1068,1384,19021,48195.0,49912.0,19104.0,,74883.0,46411.0,9022,1388,8938,886,17960,2274,19021,40.9,10.0,19021,28.4,7.0
1322,533,789,19023,52360.0,52265.0,,,,,6876,437,6901,491,13777,928,19023,45.4,10.0,19023,35.4,8.0
1384,658,726,19025,44921.0,44842.0,,,73125.0,40000.0,4349,298,4471,263,8820,561,19025,54.6,9.0,19025,40.4,7.0
2047,675,1372,19027,50559.0,51558.0,13689.0,,,48750.0,9502,392,9945,427,19447,819,19027,60.8,18.0,19027,44.4,14.0
1855,888,967,19029,43750.0,43972.0,,20750.0,,47917.0,6042,505,6474,308,12516,813,19029,73.2,15.0,19029,57.1,12.0
1393,615,778,19031,59047.0,58619.0,,,58750.0,70278.0,8437,466,8851,379,17288,845,19031,66.5,16.0,19031,40.6,10.0
5665,2333,3332,19033,46122.0,46361.0,38628.0,,41125.0,37011.0,19432,1546,20426,1418,39858,2964,19033,65.8,43.0,19033,41.7,27.0
1281,565,716,19035,48599.0,48558.0,,,,22193.0,5309,509,5252,390,10561,899,19035,47.6,10.0,19035,36.3,8.0
1067,493,574,19037,47040.0,47344.0,,,,30556.0,5706,396,5630,384,11336,780,19037,52.9,10.0,19037,44.0,8.0
1493,658,835,19039,43327.0,42865.0,,,,23932.0,3958,680,4065,439,8023,1119,19039,70.6,9.0,19039,58.4,7.0
1848,727,1121,19041,50389.0,51044.0,,,,26445.0,7388,616,7707,544,15095,1160,19041,57.8,13.0,19041,41.5,10.0
1941,799,1142,19043,48007.0,48023.0,,,51154.0,35250.0,8115,684,8114,656,16229,1340,19043,60.3,16.0,19043,37.1,10.0
6608,2840,3768,19045,50498.0,52613.0,19125.0,,14420.0,43678.0,21990,1640,22956,1284,44946,2924,19045,64.1,42.0,19045,50.5,33.0
3367,1594,1773,19047,48084.0,47846.0,,58401.0,,41985.0,7484,1129,7631,807,15115,1936,19047,54.8,12.0,19047,33.6,8.0
4796,2038,2758,19049,76320.0,77282.0,41075.0,,78794.0,57583.0,34604,2002,36040,1736,70644,3738,19049,61.6,38.0,19049,36.7,22.0
1657,662,995,19051,48888.0,48842.0,,,86000.0,70250.0,3242,1023,3150,1212,6392,2235,19051,53.6,6.0,19051,36.9,4.0
1541,722,819,19053,38560.0,38682.0,,8580.0,,,3601,468,3449,622,7050,1090,19053,65.0,7.0,19053,40.5,5.0
1717,855,862,19055,58274.0,58612.0,,,,14671.0,8234,452,8359,297,16593,749,19055,38.4,9.0,19055,25.7,6.0
6010,2095,3915,19057,44423.0,45519.0,19318.0,,76375.0,23700.0,17543,1763,19146,1255,36689,3018,19057,86.7,49.0,19057,58.6,33.0
1100,433,667,19059,57265.0,57324.0,,,,117841.0,7864,524,7901,469,15765,993,19059,59.6,18.0,19059,41.3,12.0
11189,4826,6363,19061,54605.0,55889.0,18625.0,2499.0,47083.0,36944.0,44017,2826,45546,2267,89563,5093,19061,59.4,70.0,19061,46.7,56.0
1250,524,726,19063,47795.0,47732.0,,,,60324.0,4217,614,4425,389,8642,1003,19063,69.8,10.0,19063,45.3,7.0
2550,1189,1361,19065,44928.0,45513.0,8843.0,,,37759.0,9182,997,9220,835,18402,1832,19065,59.9,19.0,19065,40.2,13.0
1957,836,1121,19067,44797.0,44947.0,,,,54083.0,7168,721,7339,613,14507,1334,19067,65.7,16.0,19067,55.1,13.0
1372,651,721,19069,48605.0,50241.0,2499.0,,,31411.0,4792,399,4761,384,9553,783,19069,54.7,8.0,19069,45.3,7.0
757,372,385,19071,53324.0,53647.0,,,,42500.0,3162,317,3270,234,6432,551,19071,76.2,8.0,19071,63.0,7.0
1135,460,675,19073,46898.0,47261.0,,,80000.0,67700.0,4174,252,4412,221,8586,473,19073,63.7,9.0,19073,56.4,8.0
757,288,469,19075,56750.0,56648.0,,,,,5728,300,6002,225,11730,525,19075,48.7,9.0,19075,33.5,6.0
1199,515,684,19077,51013.0,51382.0,,,,57500.0,4793,474,4992,343,9785,817,19077,55.6,9.0,19077,51.9,9.0
1712,700,1012,19079,49813.0,51702.0,43710.0,,32132.0,,6519,842,7204,528,13723,1370,19079,64.7,14.0,19079,41.0,9.0
924,413,511,19081,52981.0,53187.0,,,,30500.0,5254,289,5137,260,10391,549,19081,58.8,9.0,19081,47.4,8.0
1454,584,870,19083,51019.0,50965.0,,28992.0,66833.0,47989.0,7755,617,7942,535,15697,1152,19083,58.5,16.0,19083,46.9,13.0
1398,633,765,19085,53567.0,53709.0,,,,38365.0,6389,699,6658,472,13047,1171,19085,86.4,18.0,19085,48.3,10.0
2695,1303,1392,19087,49321.0,48938.0,,,51938.0,32304.0,8589,702,8945,648,17534,1350,19087,70.4,18.0,19087,51.5,13.0
1081,472,609,19089,49869.0,50151.0,,,,,4305,326,4313,376,8618,702,19089,41.9,6.0,19089,35.7,5.0
1155,447,708,19091,47252.0,47466.0,,,,27188.0,4394,301,4616,246,9010,547,19091,54.5,9.0,19091,31.0,5.0
809,395,414,19093,46993.0,47633.0,,,,29750.0,3226,300,3149,267,6375,567,19093,55.6,6.0,19093,41.7,5.0
1391,615,776,19095,59375.0,60325.0,,,,81287.0,7475,521,7678,421,15153,942,19095,47.5,11.0,19095,40.6,9.0
2343,899,1444,19097,49028.0,49616.0,,,,53534.0,8854,774,8959,794,17813,1568,19097,66.1,18.0,19097,53.8,15.0
3342,1456,1886,19099,55033.0,55551.0,36635.0,,,,15903,1312,16644,1164,32547,2476,19099,72.4,36.0,19099,53.8,27.0
2311,1294,1017,19101,42899.0,43615.0,,,2499.0,,7808,1132,7504,729,15312,1861,19101,49.5,11.0,19101,34.6,7.0
23537,11609,11928,19103,55700.0,60022.0,27608.0,,39875.0,48688.0,62291,5726,65282,4449,127573,10175,19103,50.5,53.0,19103,36.7,37.0
1950,828,1122,19105,55060.0,55341.0,,,,33641.0,8896,559,9288,493,18184,1052,19105,57.8,17.0,19105,36.6,11.0
1374,613,761,19107,43838.0,44524.0,,,,29063.0,4763,393,4784,228,9547,621,19107,68.1,10.0,19107,55.1,9.0
1357,532,825,19109,51496.0,51899.0,,,,26174.0,7112,425,7158,327,14270,752,19109,58.0,14.0,19109,41.4,10.0
5791,2606,3185,19111,43312.0,43871.0,31953.0,,53654.0,35068.0,15554,1813,15861,1472,31415,3285,19111,73.2,36.0,19111,59.7,30.0
20747,9853,10894,19113,59322.0,60826.0,26900.0,40052.0,75086.0,35469.0,98672,7125,102735,6117,201407,13242,19113,65.7,152.0,19113,47.6,110.0
1357,589,768,19115,51144.0,52341.0,36023.0,,34712.0,48667.0,5331,366,5018,426,10349,792,19115,64.1,9.0,19115,44.9,6.0
1126,596,530,19117,43962.0,44635.0,,,,,3889,436,3961,312,7850,748,19117,60.1,8.0,19117,44.5,6.0
843,404,439,19119,57130.0,56956.0,,145750.0,,77857.0,5292,567,5245,449,10537,1016,19119,45.2,7.0,19119,24.4,3.0
1164,567,597,19121,60060.0,60226.0,,,44076.0,,7185,541,7336,395,14521,936,19121,58.2,11.0,19121,40.4,8.0
3206,1330,1876,19123,48726.0,49339.0,43088.0,47857.0,53000.0,34083.0,10334,800,10558,470,20892,1270,19123,79.1,22.0,19123,66.6,19.0
3124,1459,1665,19125,54693.0,54672.0,41250.0,,77054.0,35640.0,15729,734,15889,647,31618,1381,19125,57.4,24.0,19125,43.6,18.0
4429,2268,2161,19127,53351.0,54565.0,39167.0,,54458.0,46698.0,18265,1919,18398,1389,36663,3308,19127,65.8,35.0,19127,49.3,27.0
1300,667,633,19129,63979.0,64583.0,2499.0,8920.0,,117740.0,6865,528,6811,418,13676,946,19129,73.1,13.0,19129,49.1,9.0
1005,476,529,19131,49488.0,49426.0,,,,,4662,625,4802,456,9464,1081,19131,48.2,9.0,19131,24.8,5.0
1233,529,704,19133,40302.0,40632.0,,,,81146.0,4113,336,4084,343,8197,679,19133,58.3,9.0,19133,46.6,8.0
944,348,596,19135,46304.0,46424.0,,,,,3490,602,3357,417,6847,1019,19135,74.8,9.0,19135,71.3,8.0
1717,715,1002,19137,42418.0,43214.0,,,,24792.0,4447,518,4980,327,9427,845,19137,59.0,10.0,19137,50.8,8.0
5219,2406,2813,19139,53676.0,54315.0,21761.0,96352.0,85489.0,42368.0,19539,1665,19543,1683,39082,3348,19139,62.8,31.0,19139,48.4,23.0
1013,473,540,19141,55227.0,56469.0,,,91023.0,33364.0,6514,472,6423,477,12937,949,19141,53.2,12.0,19141,39.3,9.0
521,192,329,19143,49448.0,49140.0,,,,54327.0,2812,263,2737,295,5549,558,19143,52.1,5.0,19143,47.2,5.0
2262,1116,1146,19145,43912.0,43918.0,,,112917.0,,6505,822,6810,597,13315,1419,19145,98.0,23.0,19145,50.1,12.0
948,421,527,19147,47113.0,47188.0,47054.0,,60568.0,35714.0,4213,355,4197,240,8410,595,19147,61.1,9.0,19147,35.2,5.0
1907,817,1090,19149,57130.0,57495.0,,,,27143.0,11390,766,11769,636,23159,1402,19149,54.9,18.0,19149,40.6,14.0
987,458,529,19151,45069.0,45714.0,22708.0,,,41875.0,3169,326,3264,208,6433,534,19151,52.4,6.0,19151,35.5,5.0
57143,25452,31691,19153,60061.0,62351.0,29164.0,22955.0,64090.0,41624.0,202694,17295,213559,13896,416253,31191,19153,75.3,309.0,19153,57.2,233.0
11779,5050,6729,19155,51976.0,52119.0,,,64455.0,42234.0,40374,4897,43002,3788,83376,8685,19155,84.6,94.0,19155,61.5,68.0
1767,731,1036,19157,51006.0,51119.0,,,,,8281,576,8937,594,17218,1170,19157,43.4,12.0,19157,31.8,9.0
514,206,308,19159,47042.0,47167.0,,,,,2148,282,2171,273,4319,555,19159,46.1,4.0,19159,41.2,4.0
805,304,501,19161,49572.0,49615.0,54583.0,,,37969.0,4568,358,4657,324,9225,682,19161,57.4,10.0,19161,37.7,6.0
20229,8767,11462,19163,55114.0,56953.0,32865.0,33056.0,67068.0,47304.0,74793,7742,80096,5650,154889,13392,19163,72.7,134.0,19163,53.2,99.0
1307,600,707,19165,50952.0,50645.0,,,,63692.0,5277,539,5582,372,10859,911,19165,52.4,10.0,19165,37.0,7.0
2663,1099,1564,19167,61627.0,62970.0,,,,36610.0,15807,1411,15737,1129,31544,2540,19167,43.1,16.0,19167,33.9,13.0
19109,10045,9064,19169,50438.0,52279.0,,,21900.0,31179.0,45559,2642,42773,1887,88332,4529,19169,56.0,43.0,19169,41.0,32.0
1919,903,1016,19171,55203.0,55770.0,45694.0,41625.0,,57292.0,7763,735,7896,704,15659,1439,19171,65.3,16.0,19171,39.3,10.0
860,386,474,19173,44246.0,45298.0,,,,26000.0,2683,396,2720,312,5403,708,19173,57.9,6.0,19173,52.7,5.0
1676,669,1007,19175,44351.0,44797.0,,,,,5477,483,5890,585,11367,1068,19175,74.3,13.0,19175,56.5,10.0
1095,545,550,19177,45111.0,45472.0,,,,26346.0,3256,524,3112,473,6368,997,19177,75.4,9.0,19177,52.4,6.0
6399,3090,3309,19179,42095.0,42455.0,21957.0,43125.0,57000.0,47212.0,15390,1800,16210,1526,31600,3326,19179,78.5,36.0,19179,55.5,25.0
3124,1413,1711,19181,64447.0,64813.0,56653.0,,,41273.0,21891,1175,22863,1028,44754,2203,19181,69.5,37.0,19181,48.4,25.0
2013,883,1130,19183,56390.0,57218.0,40833.0,,,37241.0,9615,1082,9902,1095,19517,2177,19183,52.9,16.0,19183,39.6,12.0
834,372,462,19185,43358.0,43535.0,,,,,2650,385,2814,433,5464,818,19185,63.7,6.0,19185,41.2,4.0
5210,2122,3088,19187,42408.0,42477.0,,,72831.0,,15924,1780,16616,1216,32540,2996,19187,67.6,34.0,19187,46.0,23.0
995,465,530,19189,47668.0,47878.0,,,69306.0,,4821,308,5032,234,9853,542,19189,61.3,10.0,19189,51.5,8.0
1507,676,831,19191,54429.0,54119.0,,14375.0,,,9724,563,9833,484,19557,1047,19191,36.0,10.0,19191,22.2,7.0
14557,6122,8435,19193,46720.0,47648.0,38203.0,22465.0,47180.0,37347.0,43575,6383,47044,4576,90619,10959,19193,71.5,79.0,19193,51.5,57.0
887,389,498,19195,48459.0,49419.0,2499.0,,,15625.0,3395,305,3519,243,6914,548,19195,45.3,5.0,19195,30.7,4.0
1412,649,763,19197,43698.0,44444.0,,,250001.0,38850.0,5785,580,5903,489,11688,1069,19197,56.1,12.0,19197,40.3,9.0
50551,24218,26333,16001,56356.0,57008.0,48844.0,34688.0,67771.0,45457.0,179687,24140,186069,21581,365756,45721,16001,52.2,191.0,16001,37.6,136.0
495,261,234,16003,39565.0,40120.0,,,,,1685,338,1408,417,3093,755,16003,69.5,5.0,16003,,
15288,7053,8235,16005,43779.0,44300.0,,42500.0,50472.0,38198.0,35907,5326,35846,5215,71753,10541,16005,41.0,32.0,16005,32.5,25.0
759,352,407,16007,48654.0,48600.0,,,,73750.0,2602,372,2618,308,5220,680,16007,,2.0,16007,,
1490,695,795,16009,39863.0,40818.0,,33625.0,71198.0,43125.0,3578,964,3616,844,7194,1808,16009,79.0,10.0,16009,67.7,9.0
6093,2801,3292,16011,50155.0,51519.0,,27000.0,52708.0,45245.0,19203,3329,19504,3105,38707,6434,16011,38.7,18.0,16011,31.9,15.0
2218,989,1229,16013,60088.0,60597.0,,,60324.0,40645.0,8753,2073,9000,1457,17753,3530,16013,22.6,5.0,16013,,
991,490,501,16015,44238.0,44167.0,,36250.0,,63333.0,3004,611,2874,368,5878,979,16015,69.2,6.0,16015,38.3,3.0
6145,2946,3199,16017,42171.0,42215.0,,,2499.0,54464.0,16871,3473,17198,3180,34069,6653,16017,54.3,32.0,16017,43.7,26.0
14025,6101,7924,16019,50762.0,51682.0,,24797.0,50469.0,36851.0,45074,7432,47260,6823,92334,14255,16019,35.7,35.0,16019,25.4,24.0
1647,774,873,16021,38961.0,38078.0,,51029.0,,63448.0,4380,1173,3939,1397,8319,2570,16021,46.3,7.0,16021,35.4,5.0
460,241,219,16023,37891.0,38984.0,,,,26823.0,1191,221,978,226,2169,447,16023,,2.0,16023,,
229,101,128,16025,42614.0,42614.0,,,,,421,117,386,128,807,245,16025,,2.0,16025,,
37945,17283,20662,16027,42888.0,43191.0,30799.0,31431.0,60449.0,36336.0,79546,18096,82935,16843,162481,34939,16027,56.1,99.0,16027,40.8,72.0
551,215,336,16029,58021.0,58212.0,,,,42222.0,3102,281,3077,258,6179,539,16029,,2.0,16029,,
3645,1616,2029,16031,45695.0,46089.0,,33750.0,,36971.0,9384,2297,9055,2252,18439,4549,16031,34.0,8.0,16031,26.9,6.0
163,98,65,16033,33672.0,34141.0,,,,26607.0,231,209,329,132,560,341,16033,,2.0,16033,,
985,423,562,16035,38837.0,38796.0,,34375.0,,51058.0,3224,522,3185,591,6409,1113,16035,55.4,8.0,16035,40.7,6.0
806,397,409,16037,39457.0,38876.0,,,,,1931,206,1642,423,3573,629,16037,52.4,4.0,16037,,
4046,1773,2273,16039,43848.0,44400.0,47353.0,,43000.0,37681.0,9973,1643,10638,1656,20611,3299,16039,72.4,17.0,16039,59.2,13.0
1696,773,923,16041,48133.0,49589.0,,,,26917.0,5577,947,5343,1001,10920,1948,16041,,2.0,16041,,
1266,601,665,16043,47988.0,49125.0,,36944.0,,33504.0,5200,902,5250,990,10450,1892,16043,40.4,6.0,16043,31.7,5.0
2980,1404,1576,16045,40828.0,41617.0,,,,25786.0,6654,1658,6630,1648,13284,3306,16045,67.1,17.0,16045,51.0,13.0
2911,1593,1318,16047,39930.0,42500.0,,33313.0,,34653.0,5885,1938,5746,1581,11631,3519,16047,66.9,12.0,16047,43.7,8.0
2528,1219,1309,16049,38191.0,38700.0,,20950.0,,47841.0,6967,1125,6473,1223,13440,2348,16049,48.2,14.0,16049,36.3,10.0
3492,1558,1934,16051,51171.0,51748.0,,,,36115.0,11265,2219,11699,1550,22964,3769,16051,33.9,7.0,16051,31.2,7.0
3676,1577,2099,16053,41630.0,42237.0,,39602.0,,34464.0,8327,3044,8345,2816,16672,5860,16053,48.0,10.0,16053,35.8,7.0
18634,8293,10341,16055,49403.0,49872.0,,37239.0,40000.0,52289.0,59838,11075,61963,10877,121801,21952,16055,56.6,96.0,16055,41.2,69.0
7597,3909,3688,16057,42439.0,43394.0,16950.0,,,,17900,1704,16876,1693,34776,3397,16057,50.6,17.0,16057,37.2,12.0
1430,657,773,16059,34329.0,33897.0,,60083.0,,,3298,602,3193,606,6491,1208,16059,46.5,7.0,16059,40.6,6.0
652,251,401,16061,36505.0,36378.0,,53750.0,,33250.0,1484,347,1502,425,2986,772,16061,66.5,4.0,16061,,
709,341,368,16063,43273.0,43935.0,,,,44732.0,1942,723,1969,587,3911,1310,16063,,2.0,16063,,
13232,6357,6875,16065,32233.0,32276.0,,,60673.0,27012.0,16867,2083,17065,1700,33932,3783,16065,,2.0,16065,,
3501,1562,1939,16067,44853.0,45534.0,17875.0,,64583.0,37571.0,7661,2570,7775,2174,15436,4744,16067,54.8,13.0,16067,38.1,9.0
4581,2166,2415,16069,48160.0,48169.0,143056.0,53487.0,,26844.0,16662,2619,17470,2343,34132,4962,16069,69.3,38.0,16069,54.0,30.0
615,292,323,16071,41338.0,41937.0,,,,31354.0,1951,229,1800,232,3751,461,16071,,2.0,16071,,
3091,1580,1511,16073,33440.0,34906.0,,27625.0,,25223.0,4083,1696,4060,1385,8143,3081,16073,40.7,5.0,16073,48.9,6.0
4152,1963,2189,16075,44257.0,44736.0,,41875.0,,39359.0,9157,2205,8899,2287,18056,4492,16075,64.8,18.0,16075,40.3,11.0
1034,353,681,16077,44779.0,43551.0,,56186.0,,40921.0,3396,471,3203,596,6599,1067,16077,41.4,3.0,16077,,
2108,1006,1102,16079,37665.0,37877.0,,,,,5282,950,5050,1088,10332,2038,16079,98.7,20.0,16079,74.8,15.0
1110,441,669,16081,53474.0,53775.0,,,,41406.0,4354,1025,3953,953,8307,1978,16081,,2.0,16081,,
12418,5566,6852,16083,44048.0,45438.0,39915.0,25325.0,34745.0,34527.0,31896,7143,33910,6119,65806,13262,16083,53.4,47.0,16083,42.0,37.0
1434,857,577,16085,48384.0,48796.0,,,,,3987,1012,3991,647,7978,1659,16085,41.3,6.0,16085,27.8,4.0
1798,886,912,16087,34775.0,35000.0,,,26875.0,26080.0,4079,918,3849,1041,7928,1959,16087,68.3,11.0,16087,54.4,8.0
9433,4259,5174,17001,45965.0,46776.0,23646.0,15859.0,49891.0,60764.0,28948,3173,31295,2375,60243,5548,17001,74.1,68.0,17001,50.8,48.0
2424,1018,1406,17003,27265.0,34142.0,17166.0,,58750.0,28333.0,2784,619,3204,517,5988,1136,17003,93.5,11.0,17003,66.0,7.0
2593,1121,1472,17005,47946.0,48504.0,45000.0,,,,7306,520,8056,347,15362,867,17005,70.2,15.0,17005,47.0,10.0
5841,2237,3604,17007,58248.0,57416.0,56845.0,103669.0,119256.0,52413.0,24063,2679,24223,2568,48286,5247,17007,66.3,36.0,17007,52.8,28.0
565,305,260,17009,50739.0,50493.0,,,,,2570,194,2292,135,4862,329,17009,81.4,6.0,17009,46.6,3.0
4191,1800,2391,17011,50423.0,50351.0,50709.0,,52431.0,42069.0,14846,1743,15866,1269,30712,3012,17011,69.6,34.0,17011,50.4,25.0
606,294,312,17013,53869.0,55147.0,,,,,2333,147,2349,90,4682,237,17013,81.4,6.0,17013,47.8,4.0
1843,894,949,17015,48631.0,48888.0,,,53750.0,48125.0,6529,829,6845,546,13374,1375,17015,54.0,14.0,17015,47.4,12.0
1688,775,913,17017,47434.0,49527.0,35515.0,,,36659.0,6014,693,5811,576,11825,1269,17017,89.7,15.0,17017,72.4,12.0
43284,21117,22167,17019,46495.0,52629.0,25921.0,47560.0,24601.0,36684.0,92122,9537,95737,6476,187859,16013,17019,62.4,107.0,17019,42.4,73.0
4714,1953,2761,17021,45334.0,45615.0,15536.0,,,65586.0,14242,1622,15615,940,29857,2562,17021,94.1,45.0,17021,69.2,33.0
2360,995,1365,17023,50517.0,50382.0,,,,2499.0,6969,759,7522,678,14491,1437,17023,75.5,17.0,17023,56.1,13.0
1839,719,1120,17025,44209.0,44224.0,,37917.0,,56094.0,5900,719,6221,566,12121,1285,17025,79.5,15.0,17025,55.8,11.0
3193,1251,1942,17027,63236.0,64114.0,,9150.0,,75184.0,16679,1061,17243,1018,33922,2079,17027,63.6,29.0,17027,43.9,20.0
10951,4833,6118,17029,39588.0,40775.0,15673.0,,,,22166,3037,25035,2111,47201,5148,17029,80.4,48.0,17029,56.1,34.0
879499,392713,486786,17031,55251.0,65946.0,34289.0,42309.0,70485.0,45366.0,2103599,410838,2348142,330018,4451741,740856,17031,63.4,3359.0,17031,44.7,2369.0
2310,1127,1183,17033,47468.0,47670.0,101346.0,2499.0,81181.0,14655.0,7860,1003,8562,736,16422,1739,17033,88.9,24.0,17033,55.5,15.0
1700,755,945,17035,46061.0,46414.0,,,2499.0,26250.0,5052,410,5011,344,10063,754,17035,89.1,13.0,17035,62.6,9.0
18336,7881,10455,17037,54101.0,57900.0,21072.0,,38824.0,41786.0,45996,5120,47894,4510,93890,9630,17037,72.8,63.0,17037,46.2,40.0
2073,936,1137,17039,53959.0,54467.0,,107917.0,,31466.0,7261,845,7595,448,14856,1293,17039,94.3,21.0,17039,78.1,17.0
2019,829,1190,17041,51810.0,51974.0,,49000.0,,41985.0,7827,1829,8266,1748,16093,3577,17041,66.3,17.0,17041,46.2,12.0
67941,30099,37842,17043,79658.0,81187.0,51329.0,55500.0,95020.0,58347.0,411862,42255,435524,34940,847386,77195,17043,56.1,529.0,17043,38.7,362.0
2999,1370,1629,17045,45691.0,45755.0,,,60625.0,,7988,698,8274,762,16262,1460,17045,76.6,20.0,17045,59.7,16.0
851,364,487,17047,44497.0,44549.0,,,,2499.0,2924,344,3146,201,6070,545,17047,88.7,9.0,17047,60.7,6.0
3557,1758,1799,17049,52224.0,52243.0,,,65435.0,48125.0,15617,1332,15938,1040,31555,2372,17049,67.5,29.0,17049,45.2,19.0
3644,1651,1993,17051,43944.0,44007.0,,,,,8549,1573,9305,1070,17854,2643,17051,58.0,16.0,17051,43.7,13.0
1790,792,998,17053,49947.0,49681.0,88077.0,55089.0,,43452.0,5896,759,6325,444,12221,1203,17053,66.8,14.0,17053,48.3,11.0
7191,3279,3912,17055,39512.0,39761.0,41042.0,19191.0,31875.0,33125.0,17019,2304,17973,1920,34992,4224,17055,103.4,59.0,17055,73.7,42.0
4838,2193,2645,17057,46083.0,45967.0,,,21250.0,,15208,1655,16087,1139,31295,2794,17057,74.9,38.0,17057,54.2,28.0
837,375,462,17059,39636.0,40133.0,,,,,2279,291,2598,217,4877,508,17059,87.9,8.0,17059,74.1,7.0
2231,994,1237,17061,42565.0,42773.0,,,,,5958,630,6055,601,12013,1231,17061,72.7,14.0,17061,55.7,11.0
4531,1897,2634,17063,65887.0,67212.0,30743.0,,,56676.0,23054,1929,23379,1691,46433,3620,17063,90.0,45.0,17063,55.3,28.0
1211,565,646,17065,44159.0,44159.0,,,,,3633,433,3779,396,7412,829,17065,85.2,11.0,17065,80.2,10.0
2159,950,1209,17067,47699.0,48171.0,,26250.0,40250.0,,8424,750,8769,629,17193,1379,17067,74.4,21.0,17067,54.9,16.0
864,355,509,17069,38838.0,38596.0,,,91250.0,,1854,295,1872,172,3726,467,17069,90.3,6.0,17069,57.4,4.0
692,230,462,17071,47672.0,47672.0,,,,,3131,263,3331,252,6462,515,17071,78.2,9.0,17071,62.3,7.0
5256,2166,3090,17073,53480.0,54257.0,17679.0,,56544.0,38589.0,22242,2034,23560,1281,45802,3315,17073,74.9,52.0,17073,57.1,40.0
4735,2010,2725,17075,47834.0,48692.0,21378.0,,48125.0,37167.0,12646,1403,13538,1009,26184,2412,17075,72.0,31.0,17075,52.0,23.0
16853,8533,8320,17077,33871.0,38689.0,15280.0,22578.0,32132.0,20517.0,26309,3171,27085,2267,53394,5438,17077,69.0,41.0,17077,47.2,28.0
881,319,562,17079,54209.0,54238.0,,,,,4354,425,4455,338,8809,763,17079,67.3,9.0,17079,64.3,8.0
6179,2740,3439,17081,43247.0,44648.0,31696.0,,72798.0,36042.0,16146,1840,16917,1633,33063,3473,17081,92.7,46.0,17081,68.7,34.0
1590,559,1031,17083,53271.0,53261.0,,,,61314.0,9880,1023,10390,988,20270,2011,17083,78.7,23.0,17083,62.3,19.0
2032,849,1183,17085,53221.0,53160.0,,,120000.0,36224.0,10402,789,10313,741,20715,1530,17085,55.9,22.0,17085,44.8,17.0
1589,761,828,17087,42287.0,42559.0,,,,42500.0,4825,579,5104,431,9929,1010,17087,83.6,15.0,17087,60.5,10.0
59033,26663,32370,17089,70696.0,77290.0,39620.0,36705.0,92529.0,49138.0,224538,34989,234737,27421,459275,62410,17089,58.9,266.0,17089,43.7,193.0
17365,7945,9420,17091,52110.0,56820.0,28198.0,40823.0,71389.0,42650.0,47095,6334,52251,4214,99346,10548,17091,73.6,94.0,17091,55.1,70.0
6616,2622,3994,17093,84385.0,86339.0,83685.0,,90037.0,62889.0,55861,3639,57763,2523,113624,6162,17093,54.6,45.0,17093,39.3,32.0
9013,4050,4963,17095,39976.0,41632.0,18852.0,,,31809.0,21329,2604,23479,1962,44808,4566,17095,69.1,53.0,17095,52.5,40.0
65728,30540,35188,17097,78026.0,80823.0,39812.0,54583.0,102820.0,49365.0,300937,38450,317800,30477,618737,68927,17097,58.2,379.0,17097,40.1,257.0
14386,6252,8134,17099,50633.0,51022.0,31082.0,,65625.0,46320.0,48455,5875,50956,4462,99411,10337,17099,76.4,113.0,17099,56.5,84.0
1509,549,960,17101,40841.0,41069.0,60500.0,,,53150.0,4119,444,6007,591,10126,1035,17101,88.2,19.0,17101,66.4,14.0
3555,1680,1875,17103,52379.0,52653.0,61250.0,23512.0,,40625.0,14529,1484,14968,1281,29497,2765,17103,66.9,31.0,17103,53.2,25.0
3897,1699,2198,17105,54254.0,54268.0,,,,35000.0,15541,1274,15881,997,31422,2271,17105,81.6,40.0,17105,49.7,25.0
3303,1336,1967,17107,50539.0,53480.0,16318.0,66094.0,49565.0,56908.0,10390,973,11924,710,22314,1683,17107,90.7,34.0,17107,52.9,20.0
6394,2743,3651,17109,40314.0,40744.0,,31071.0,46544.0,,14128,1315,15125,1068,29253,2383,17109,63.1,23.0,17109,50.1,18.0
24037,11663,12374,17111,77222.0,77649.0,68333.0,55750.0,95059.0,57853.0,139659,12815,142634,10986,282293,23801,17111,65.3,185.0,17111,51.9,143.0
23795,10918,12877,17113,62211.0,64586.0,27227.0,42321.0,82436.0,39873.0,77943,5782,83708,4527,161651,10309,17113,64.1,97.0,17113,44.7,68.0
19411,8246,11165,17115,47176.0,51454.0,21997.0,,73750.0,47067.0,45971,5397,51455,3950,97426,9347,17115,96.6,140.0,17115,62.8,92.0
5729,2375,3354,17117,51206.0,51102.0,105039.0,,58490.0,78409.0,20678,2287,21756,1563,42434,3850,17117,79.5,52.0,17117,59.9,39.0
34818,15421,19397,17119,53431.0,55845.0,30120.0,,47652.0,44482.0,117515,12327,126195,8900,243710,21227,17119,83.5,265.0,17119,58.5,186.0
6965,3100,3865,17121,42238.0,43310.0,30912.0,13810.0,62632.0,23571.0,16340,2262,17635,1717,33975,3979,17121,91.5,49.0,17121,67.6,36.0
1201,439,762,17123,53423.0,53658.0,,,,53802.0,5466,436,5677,329,11143,765,17123,58.5,12.0,17123,44.0,9.0
2095,919,1176,17125,41567.0,41624.0,,,,,6283,631,6482,537,12765,1168,17125,92.3,20.0,17125,63.9,14.0
2705,1251,1454,17127,40977.0,42512.0,23194.0,,35938.0,83452.0,6263,903,6897,731,13160,1634,17127,100.9,22.0,17127,67.9,15.0
1404,603,801,17129,60486.0,60425.0,,,,,5691,395,6065,299,11756,694,17129,75.9,13.0,17129,62.1,10.0
1498,616,882,17131,54757.0,54468.0,,,66500.0,45625.0,7464,421,7559,407,15023,828,17131,76.7,19.0,17131,48.2,12.0
1667,529,1138,17133,70859.0,71255.0,,,,64417.0,15483,875,16248,643,31731,1518,17133,60.9,24.0,17133,43.6,17.0
3503,1170,2333,17135,46966.0,46862.0,,,,66500.0,9479,581,13000,822,22479,1403,17135,86.5,34.0,17135,68.5,28.0
4580,2222,2358,17137,45978.0,47783.0,30265.0,,,35714.0,14710,1702,15971,980,30681,2682,17137,77.6,36.0,17137,50.2,23.0
1929,1000,929,17139,49681.0,49910.0,,,,35357.0,6220,961,6573,851,12793,1812,17139,56.9,11.0,17139,46.1,9.0
5477,2460,3017,17141,54849.0,55420.0,42070.0,66000.0,,38979.0,23669,2237,23986,2004,47655,4241,17141,66.7,45.0,17141,45.8,31.0
31194,13602,17592,17143,51147.0,56363.0,25998.0,51250.0,83385.0,43125.0,80195,9174,88941,6532,169136,15706,17143,84.0,180.0,17143,60.1,129.0
3380,1383,1997,17145,42478.0,43366.0,19917.0,,,,8538,1052,9344,779,17882,1831,17145,74.4,21.0,17145,52.8,15.0
1019,398,621,17147,66261.0,66763.0,,,,42292.0,7673,465,7898,409,15571,874,17147,79.8,18.0,17147,53.1,12.0
2133,1011,1122,17149,40588.0,40865.0,,8750.0,250001.0,39844.0,6805,886,7199,721,14004,1607,17149,68.4,17.0,17149,46.0,11.0
615,247,368,17151,39223.0,38851.0,,,,,1911,159,1934,122,3845,281,17151,105.5,7.0,17151,69.4,4.0
1178,529,649,17153,31980.0,35236.0,25106.0,,,23500.0,2536,325,2743,259,5279,584,17153,113.1,10.0,17153,74.3,7.0
691,304,387,17155,56358.0,55776.0,,,,63125.0,2658,278,2665,215,5323,493,17155,73.5,7.0,17155,55.0,5.0
3816,1716,2100,17157,48158.0,50465.0,26875.0,,,68500.0,13720,1275,13830,1116,27550,2391,17157,78.6,33.0,17157,52.6,22.0
2382,1001,1381,17159,44127.0,44340.0,,,,31250.0,7236,745,7280,656,14516,1401,17159,81.6,19.0,17159,56.7,13.0
21223,9137,12086,17161,48817.0,50760.0,31869.0,18906.0,63359.0,40236.0,63474,7177,68428,5696,131902,12873,17161,66.8,127.0,17161,52.4,101.0
47946,20261,27685,17163,49895.0,61682.0,27289.0,,72440.0,41273.0,109781,15069,125311,11067,235092,26136,17163,75.8,219.0,17163,56.8,165.0
5534,2362,3172,17165,38258.0,39217.0,,,48182.0,24375.0,10329,1377,11365,1164,21694,2541,17165,91.8,33.0,17165,69.5,25.0
30297,13769,16528,17167,56167.0,61044.0,26468.0,53281.0,67159.0,41054.0,85893,8590,96636,5726,182529,14316,17167,77.6,183.0,17167,54.1,126.0
1382,885,497,17169,47723.0,47482.0,,,,24375.0,2901,954,3084,293,5985,1247,17169,82.9,9.0,17169,61.5,7.0
712,332,380,17171,47222.0,47118.0,,,,,2232,281,2485,152,4717,433,17171,83.2,6.0,17171,52.1,4.0
2449,1159,1290,17173,47850.0,48071.0,,,39750.0,,9821,1147,10223,732,20044,1879,17173,77.1,25.0,17173,46.9,16.0
684,271,413,17175,50085.0,50321.0,,,,60625.0,2569,280,2704,205,5273,485,17175,77.3,7.0,17175,46.5,4.0
6849,2985,3864,17177,45331.0,47191.0,24795.0,,,41667.0,20113,2171,22010,1584,42123,3755,17177,63.8,43.0,17177,52.6,36.0
11559,4787,6772,17179,58194.0,58688.0,,,98304.0,62118.0,60428,4933,63659,4342,124087,9275,17179,87.2,151.0,17179,60.1,104.0
2971,1495,1476,17181,42606.0,44158.0,,,,23500.0,7728,927,7935,808,15663,1735,17181,102.7,26.0,17181,74.4,18.0
14571,6430,8141,17183,42977.0,46159.0,23053.0,21648.0,51472.0,35583.0,33321,4625,37214,2928,70535,7553,17183,86.4,92.0,17183,64.8,70.0
1447,617,830,17185,47491.0,46933.0,,,75500.0,2499.0,5240,427,5446,456,10686,883,17185,91.6,15.0,17185,59.7,10.0
2464,992,1472,17187,43699.0,44519.0,39821.0,,36875.0,35781.0,7792,751,8299,666,16091,1417,17187,74.0,17.0,17187,57.1,13.0
1834,861,973,17189,53202.0,53370.0,2499.0,,87813.0,35500.0,6555,581,6684,428,13239,1009,17189,74.1,15.0,17189,43.4,9.0
2385,1052,1333,17191,44993.0,45230.0,2499.0,,,,7396,786,7712,612,15108,1398,17191,89.2,22.0,17191,66.4,17.0
1916,825,1091,17193,44648.0,44295.0,,,,35603.0,6151,687,6747,545,12898,1232,17193,81.2,18.0,17193,69.5,16.0
6740,2999,3741,17195,47401.0,47739.0,34554.0,,123375.0,43133.0,25020,2804,26751,2076,51771,4880,17195,71.8,57.0,17195,56.7,45.0
53482,22781,30701,17197,76101.0,79701.0,55017.0,41618.0,107870.0,59611.0,303905,30668,319482,23374,623387,54042,17197,72.0,414.0,17197,50.3,281.0
9783,4284,5499,17199,44453.0,44983.0,31181.0,,72232.0,48021.0,28472,3366,30947,2498,59419,5864,17199,97.5,85.0,17199,69.5,60.0
47851,21483,26368,17201,48225.0,51923.0,25371.0,34617.0,63722.0,37495.0,123333,16996,134331,12616,257664,29612,17201,74.0,252.0,17201,57.7,198.0
3105,1461,1644,17203,65852.0,65909.0,,,,65179.0,17966,1257,18355,970,36321,2227,17203,61.0,29.0,17203,45.8,22.0
5529,2596,2933,18001,48188.0,49107.0,,,,51473.0,12964,4012,13100,4142,26064,8154,18001,50.2,19.0,18001,32.9,13.0
56542,25163,31379,18003,49092.0,52934.0,27017.0,40725.0,42569.0,37399.0,150074,25374,160131,24245,310205,49619,18003,61.9,227.0,18003,44.8,163.0
10027,4645,5382,18005,55050.0,53707.0,51758.0,,88061.0,40043.0,34684,4348,34960,4574,69644,8922,18005,77.8,69.0,18005,59.2,53.0
1181,512,669,18007,47046.0,47074.0,46250.0,,,33958.0,3646,702,3807,512,7453,1214,18007,82.7,9.0,18007,79.3,9.0
1700,664,1036,18009,38190.0,38326.0,,,,,5134,903,5344,923,10478,1826,18009,74.9,13.0,18009,51.8,10.0
3498,1551,1947,18011,67552.0,67769.0,,,81250.0,53836.0,27235,2530,27975,2173,55210,4703,18011,67.0,39.0,18011,56.6,31.0
1865,959,906,18013,54615.0,54961.0,,,,76731.0,6408,1077,6463,932,12871,2009,18013,61.8,14.0,18013,60.2,13.0
2149,895,1254,18015,52005.0,51852.0,,,,33643.0,8330,1557,8678,1334,17008,2891,18015,66.1,17.0,18015,39.8,10.0
5884,2717,3167,18017,42290.0,43277.0,,,54107.0,32148.0,15674,3128,16226,2792,31900,5920,18017,89.5,42.0,18017,65.8,31.0
12009,5616,6393,18019,51699.0,53170.0,39841.0,,48783.0,50982.0,46813,7703,50697,6414,97510,14117,18019,88.1,107.0,18019,67.3,81.0
3807,1695,2112,18021,47602.0,47960.0,,7109.0,,,11270,1629,11934,1533,23204,3162,18021,73.8,25.0,18021,58.4,20.0
4504,2018,2486,18023,48478.0,48946.0,42692.0,68906.0,49904.0,35441.0,13628,2176,14134,2246,27762,4422,18023,76.2,29.0,18023,62.2,24.0
2166,975,1191,18025,38695.0,38618.0,,47614.0,,36635.0,4818,520,4698,496,9516,1016,18025,94.6,13.0,18025,70.5,10.0
4192,1934,2258,18027,47342.0,47598.0,,,,40515.0,12618,3375,12601,3357,25219,6732,18027,62.8,23.0,18027,56.0,20.0
4553,1982,2571,18029,58680.0,58943.0,31324.0,,,61850.0,22206,2249,22495,2168,44701,4417,18029,82.3,48.0,18029,64.1,37.0
3647,1518,2129,18031,49799.0,49314.0,37059.0,,57352.0,,11143,1689,11404,1686,22547,3375,18031,69.6,21.0,18031,56.9,17.0
6107,2741,3366,18033,48341.0,48097.0,,,61354.0,34777.0,18100,2885,18259,2832,36359,5717,18033,68.5,33.0,18033,53.2,25.0
24209,10795,13414,18035,38830.0,40362.0,25152.0,15870.0,15987.0,28313.0,47799,7995,53817,6250,101616,14245,18035,79.9,108.0,18035,58.6,80.0
4071,1772,2299,18037,53513.0,54508.0,,,,27166.0,19082,1645,19285,1483,38367,3128,18037,55.0,28.0,18037,40.3,20.0
31601,12817,18784,18039,47913.0,49448.0,22094.0,49922.0,66944.0,40256.0,78600,19159,81781,18674,160381,37833,18039,70.2,144.0,18039,48.6,99.0
4806,2129,2677,18041,39379.0,40301.0,29402.0,,40481.0,22138.0,9694,1943,9985,1830,19679,3773,18041,87.4,29.0,18041,71.4,24.0
9530,4041,5489,18043,54914.0,57181.0,22254.0,28382.0,63125.0,48409.0,32243,4169,34587,3904,66830,8073,18043,79.3,67.0,18043,54.2,46.0
1992,870,1122,18045,46760.0,47100.0,,,,43462.0,7363,1018,7597,737,14960,1755,18045,82.3,20.0,18045,62.2,15.0
2413,1094,1319,18047,51748.0,51579.0,,,,58977.0,10385,1059,10442,968,20827,2027,18047,64.7,18.0,18047,57.1,16.0
3011,1441,1570,18049,45332.0,45206.0,70972.0,,,44792.0,8761,1357,8876,1304,17637,2661,18049,83.8,23.0,18049,70.0,19.0
3675,1611,2064,18051,48303.0,48964.0,33889.0,,,,14615,1936,14958,1606,29573,3542,18051,70.0,29.0,18051,48.6,20.0
11829,5068,6761,18053,40294.0,41915.0,24351.0,23203.0,35677.0,38021.0,27995,4428,31014,4506,59009,8934,18053,85.5,78.0,18053,64.0,59.0
4398,1869,2529,18055,45397.0,45665.0,,,,40385.0,13772,2387,14446,1927,28218,4314,18055,81.1,35.0,18055,69.5,30.0
13889,5730,8159,18057,86222.0,86143.0,68029.0,67063.0,104491.0,66445.0,133967,10141,141488,9471,275455,19612,18057,46.7,102.0,18057,33.6,73.0
4583,1738,2845,18059,66606.0,66779.0,,,88700.0,72202.0,31559,3012,33142,2993,64701,6005,18059,83.1,65.0,18059,59.2,45.0
5392,2399,2993,18061,52128.0,52081.0,114278.0,,,68833.0,17348,2105,17730,1840,35078,3945,18061,90.7,43.0,18061,62.9,29.0
7514,2643,4871,18063,70163.0,70927.0,64035.0,30408.0,61121.0,54239.0,67526,6690,70754,5627,138280,12317,18063,69.9,98.0,18063,50.5,69.0
7465,3105,4360,18065,41855.0,42009.0,,58036.0,,35208.0,18933,3496,20315,3185,39248,6681,18065,76.6,49.0,18065,65.1,42.0
14445,6520,7925,18067,44226.0,46114.0,21813.0,,46964.0,41332.0,34676,4721,37634,4798,72310,9519,18067,75.0,81.0,18067,52.4,57.0
4241,1829,2412,18069,46945.0,46941.0,,78125.0,60650.0,32083.0,15653,2203,16607,1913,32260,4116,18069,65.0,29.0,18069,50.5,23.0
6297,2608,3689,18071,47000.0,47824.0,,20000.0,90033.0,28243.0,18573,2785,18665,2816,37238,5601,18071,81.4,42.0,18071,70.7,37.0
2710,1252,1458,18073,55374.0,55925.0,42014.0,,,53478.0,14816,1581,14772,1932,29588,3513,18073,85.6,33.0,18073,69.4,27.0
3400,1570,1830,18075,41021.0,40993.0,,30750.0,120521.0,,8849,1480,9460,1250,18309,2730,18075,68.9,18.0,18075,57.7,15.0
4343,1949,2394,18077,45718.0,45900.0,40441.0,,50938.0,45060.0,13271,2024,13793,1916,27064,3940,18077,81.7,32.0,18077,58.5,23.0
4390,2189,2201,18079,44736.0,45379.0,19750.0,,26250.0,,12221,1730,12293,1615,24514,3345,18079,97.9,30.0,18079,62.5,20.0
14205,6368,7837,18081,62147.0,62622.0,69279.0,47039.0,66106.0,26880.0,62927,7284,66581,6702,129508,13986,18081,67.9,101.0,18081,50.1,73.0
5630,2479,3151,18083,42725.0,43270.0,36477.0,,,33646.0,16560,2242,15792,2655,32352,4897,18083,76.0,37.0,18083,53.6,26.0
8645,3964,4681,18085,52821.0,53105.0,48650.0,,82177.0,46228.0,32774,5682,33738,5039,66512,10721,18085,71.6,64.0,18085,54.0,47.0
4909,2157,2752,18087,49964.0,49958.0,,40469.0,,40170.0,11118,8061,10668,8069,21786,16130,18087,56.4,21.0,18087,41.5,15.0
87203,37304,49899,18089,50135.0,58970.0,31299.0,53828.0,74844.0,47355.0,201307,34810,220117,31833,421424,66643,18089,74.0,412.0,18089,53.8,298.0
17792,7191,10601,18091,46872.0,50346.0,25071.0,35505.0,32152.0,39933.0,43254,5861,47298,5999,90552,11860,18091,77.2,103.0,18091,55.9,74.0
5850,2758,3092,18093,45875.0,46347.0,,,,27054.0,18953,3406,19695,3087,38648,6493,18093,89.5,55.0,18093,66.0,41.0
21089,9753,11336,18095,44195.0,45970.0,30488.0,,22361.0,27417.0,51832,8896,56889,7522,108721,16418,18095,81.8,133.0,18095,67.8,111.0
191309,86399,104910,18097,42168.0,49931.0,30508.0,35283.0,47899.0,29004.0,362748,78114,411127,64482,773875,142596,18097,79.7,682.0,18097,64.3,545.0
5594,2265,3329,18099,48485.0,48479.0,,89271.0,,39316.0,19603,3532,19708,3640,39311,7172,18099,67.1,39.0,18099,45.1,26.0
1320,532,788,18101,44589.0,45671.0,,,,,4408,705,4409,647,8817,1352,18101,71.5,10.0,18101,58.6,8.0
5174,2271,2903,18103,45184.0,45321.0,64964.0,38750.0,,38333.0,15202,2349,14794,1817,29996,4166,18103,77.1,34.0,18103,68.0,29.0
31707,15337,16370,18105,42404.0,45342.0,21604.0,43701.0,15759.0,35156.0,62102,8313,63785,7277,125887,15590,18105,66.9,81.0,18105,49.7,61.0
5153,2408,2745,18107,48213.0,48202.0,50645.0,,105859.0,32120.0,16552,2590,16354,2147,32906,4737,18107,70.0,33.0,18107,54.5,26.0
8237,3406,4831,18109,55432.0,55947.0,,,,40000.0,29956,3980,31211,3523,61167,7503,18109,83.9,65.0,18109,66.4,52.0
1892,703,1189,18111,46895.0,46868.0,,,,54357.0,5948,1060,5930,916,11878,1976,18111,75.3,15.0,18111,65.7,13.0
5665,2582,3083,18113,49331.0,49246.0,,95288.0,,42721.0,20425,2984,20259,3059,40684,6043,18113,69.0,35.0,18113,54.7,28.0
470,219,251,18115,48780.0,48601.0,,,,,2633,363,2688,297,5321,660,18115,123.2,10.0,18115,80.6,7.0
3403,1562,1841,18117,39812.0,39888.0,,,,,8431,1230,8677,1134,17108,2364,18117,85.4,22.0,18117,69.7,18.0
3172,1535,1637,18119,43948.0,44024.0,,,,,8672,1969,8981,1411,17653,3380,18119,85.0,24.0,18119,62.9,17.0
2486,1103,1383,18121,40781.0,41169.0,,,,21607.0,6668,1341,6589,981,13257,2322,18121,75.1,17.0,18121,64.0,14.0
2276,1020,1256,18123,47470.0,48240.0,21225.0,,,,7972,836,8028,831,16000,1667,18123,101.2,24.0,18123,76.0,18.0
1243,579,664,18125,44399.0,44620.0,,,,,5557,670,5607,629,11164,1299,18125,66.6,12.0,18125,57.9,10.0
18850,8093,10757,18127,63926.0,64594.0,42720.0,,80938.0,62785.0,73133,8037,75759,8265,148892,16302,18127,73.6,133.0,18127,52.9,95.0
2801,1480,1321,18129,58101.0,59167.0,54306.0,,,,11771,823,11940,782,23711,1605,18129,60.3,19.0,18129,41.3,13.0
1808,707,1101,18131,43836.0,44138.0,15833.0,,,32232.0,5661,855,5588,777,11249,1632,18131,71.1,13.0,18131,64.5,12.0
3245,1391,1854,18133,51355.0,51613.0,45089.0,,73194.0,,14904,2042,15700,1728,30604,3770,18133,95.1,41.0,18133,76.4,33.0
4522,1782,2740,18135,40810.0,41008.0,45000.0,,,31857.0,10277,2030,11109,1822,21386,3852,18135,83.1,29.0,18135,59.1,21.0
2403,1042,1361,18137,51170.0,51376.0,,,,51500.0,12406,1488,13193,1063,25599,2551,18137,75.6,27.0,18137,57.8,20.0
2946,1189,1757,18139,45121.0,45833.0,30153.0,,,,7088,1260,7480,976,14568,2236,18139,80.8,18.0,18139,67.5,15.0
45532,19992,25540,18141,45471.0,49959.0,23364.0,26769.0,53302.0,37091.0,110161,17834,121115,15619,231276,33453,18141,71.5,212.0,18141,52.2,157.0
4148,1896,2252,18143,44442.0,44526.0,,,,,9893,1578,10912,1052,20805,2630,18143,91.8,26.0,18143,81.2,23.0
5302,2258,3044,18145,53584.0,54330.0,23872.0,,100139.0,42326.0,18589,2948,19630,2561,38219,5509,18145,81.8,43.0,18145,56.2,30.0
2213,906,1307,18147,55247.0,55317.0,55625.0,,,,9548,894,9375,821,18923,1715,18147,77.9,21.0,18147,51.3,14.0
3682,1634,2048,18149,42208.0,43110.0,,,55833.0,35827.0,10130,1260,10415,1307,20545,2567,18149,93.5,29.0,18149,75.3,23.0
3542,1577,1965,18151,48472.0,48554.0,,70625.0,55278.0,46130.0,15095,2153,14737,2002,29832,4155,18151,71.0,31.0,18151,46.7,20.0
3534,1469,2065,18153,45023.0,45018.0,,,,,7878,1578,8160,1317,16038,2895,18153,81.8,22.0,18153,64.0,17.0
2022,1025,997,18155,44061.0,43626.0,64250.0,,,,4519,866,4272,731,8791,1597,18155,84.7,11.0,18155,80.0,10.0
36902,18433,18469,18157,45932.0,49335.0,19199.0,71071.0,21343.0,40556.0,80039,11380,78153,9682,158192,21062,18157,64.0,91.0,18157,47.2,66.0
1529,732,797,18159,51613.0,51935.0,,,,,6741,937,6682,1027,13423,1964,18159,73.3,16.0,18159,43.6,10.0
754,372,382,18161,44277.0,44818.0,,,,,3159,488,3209,381,6368,869,18161,65.2,7.0,18161,48.9,5.0
28870,12815,16055,18163,43046.0,46584.0,21430.0,23854.0,44797.0,39545.0,75092,11396,82866,9443,157958,20839,18163,79.6,169.0,18163,57.2,122.0
1996,896,1100,18165,43600.0,43728.0,,,,29280.0,6822,900,7071,856,13893,1756,18165,92.6,20.0,18165,79.9,18.0
20245,9199,11046,18167,40313.0,41000.0,24240.0,45956.0,51364.0,36576.0,44041,7289,45578,7081,89619,14370,18167,80.4,96.0,18167,65.0,77.0
4373,1771,2602,18169,45649.0,45263.0,,59231.0,,50870.0,13812,1655,14518,1409,28330,3064,18169,64.3,28.0,18169,46.5,20.0
740,297,443,18171,56042.0,56222.0,,,,95938.0,3822,278,3874,301,7696,579,18171,66.0,7.0,18171,53.6,6.0
5926,2551,3375,18173,62185.0,62256.0,49500.0,23830.0,,43295.0,27350,2520,28236,2148,55586,4668,18173,66.7,47.0,18173,46.7,32.0
4190,1900,2290,18175,41289.0,41920.0,,,,,11739,1976,12453,1484,24192,3460,18175,96.2,33.0,18175,69.6,23.0
13732,6012,7720,18177,38494.0,39232.0,28188.0,,,27270.0,26546,5708,28928,5548,55474,11256,18177,85.2,77.0,18177,65.0,58.0
3306,1449,1857,18179,51101.0,51730.0,38167.0,,,30523.0,12159,1298,12294,1480,24453,2778,18179,52.4,19.0,18179,42.9,15.0
2309,1029,1280,18181,52154.0,52199.0,,,,40194.0,10690,1293,10944,1212,21634,2505,18181,76.2,26.0,18181,64.4,22.0
2633,1208,1425,18183,54389.0,54561.0,,67917.0,35833.0,,14968,1515,15078,1388,30046,2903,18183,63.8,26.0,18183,52.1,21.0
2257,957,1300,20001,38698.0,39505.0,38482.0,20833.0,,39500.0,5602,779,5754,741,11356,1520,20001,,,20001,52.2,10.0
1362,668,694,20003,40696.0,40370.0,,81200.0,,,3391,487,3407,509,6798,996,20003,,,20003,50.6,6.0
2970,1310,1660,20005,43581.0,44353.0,22375.0,,,,6755,1145,7594,963,14349,2108,20005,,,20005,51.1,10.0
511,245,266,20007,51811.0,51658.0,,,,65938.0,2170,220,2078,261,4248,481,20007,,,20007,56.0,4.0
4261,1840,2421,20009,44013.0,45325.0,22326.0,18958.0,,22247.0,11051,2075,12159,1703,23210,3778,20009,,,20009,45.5,17.0
2757,1175,1582,20011,38280.0,39231.0,,,62344.0,40250.0,6495,677,6594,773,13089,1450,20011,,,20011,47.5,10.0
1598,669,929,20013,43724.0,45619.0,32366.0,30268.0,48125.0,30119.0,4257,506,4456,590,8713,1096,20013,,,20013,53.6,8.0
6620,2830,3790,20015,58897.0,58928.0,,19487.0,77460.0,58136.0,28486,2977,29710,2918,58196,5895,20015,,,20015,53.0,38.0
360,164,196,20017,38707.0,39655.0,,,,58333.0,1131,124,1222,125,2353,249,20017,,,20017,,
579,261,318,20019,37993.0,39079.0,,,,73125.0,1521,247,1429,246,2950,493,20019,,,20019,80.1,5.0
3511,1673,1838,20021,41388.0,41126.0,,51393.0,,71528.0,8766,1516,9103,1346,17869,2862,20021,,,20021,63.2,17.0
214,93,121,20023,44500.0,43875.0,,,,25893.0,1218,121,1176,126,2394,247,20023,,,20023,,
311,128,183,20025,42589.0,42589.0,,,,38393.0,923,102,947,113,1870,215,20025,,,20025,,
942,368,574,20027,52066.0,52293.0,,75278.0,,,3729,200,3921,272,7650,472,20027,,,20027,52.9,7.0
1202,623,579,20029,39282.0,39421.0,,,,,3958,606,4098,452,8056,1058,20029,,,20029,48.4,7.0
833,425,408,20031,57433.0,56964.0,,70682.0,,,3749,456,3769,372,7518,828,20031,,,20031,54.4,7.0
140,40,100,20033,45288.0,46010.0,,,,,871,110,801,154,1672,264,20033,,,20033,,
5971,2742,3229,20035,43860.0,43915.0,45347.0,41875.0,61200.0,38750.0,15033,2174,15862,1800,30895,3974,20035,,,20035,43.1,20.0
8219,4161,4058,20037,36534.0,37157.0,31500.0,,2499.0,29961.0,16719,2730,16792,2435,33511,5165,20037,,,20037,59.0,26.0
316,108,208,20039,40657.0,40833.0,,,,,1209,202,1258,150,2467,352,20039,,,20039,,
2005,735,1270,20041,49096.0,49245.0,,110543.0,,45903.0,8495,940,8913,684,17408,1624,20041,,,20041,54.8,15.0
892,444,448,20043,47209.0,49209.0,18182.0,36083.0,,33750.0,3369,577,3345,455,6714,1032,20043,,,20043,58.1,6.0
20137,10447,9690,20045,50939.0,52173.0,38934.0,60144.0,29554.0,39315.0,51058,6065,51232,5902,102290,11967,20045,,,20045,41.2,36.0
335,161,174,20047,47303.0,48139.0,,,,36154.0,1290,168,1206,232,2496,400,20047,,,20047,,
483,241,242,20049,36458.0,36111.0,,,,63611.0,1202,115,1159,159,2361,274,20049,,,20049,56.1,3.0
4353,2259,2094,20051,45579.0,47280.0,,,2499.0,25263.0,12905,1447,13225,1140,26130,2587,20051,,,20051,37.7,12.0
484,171,313,20053,47736.0,48615.0,,,,50208.0,2503,175,2531,190,5034,365,20053,,,20053,42.8,4.0
6222,2572,3650,20055,49227.0,52302.0,29522.0,26458.0,48732.0,44520.0,15943,2762,15431,2753,31374,5515,20055,,,20055,40.2,11.0
6183,3303,2880,20057,50777.0,51687.0,21447.0,55682.0,27895.0,44796.0,14180,3495,13457,3112,27637,6607,20057,,,20057,41.2,12.0
3264,1515,1749,20059,51081.0,52234.0,,,,30302.0,11434,1146,11906,1105,23340,2251,20059,,,20059,53.0,16.0
4463,1978,2485,20061,43992.0,43804.0,46568.0,44583.0,41641.0,32679.0,12763,1900,15626,1357,28389,3257,20061,,,20061,71.4,16.0
219,119,100,20063,46364.0,46288.0,,,,,1197,166,1179,139,2376,305,20063,,,20063,,
287,85,202,20065,43826.0,46964.0,31250.0,,,46250.0,1142,110,1230,83,2372,193,20065,,,20065,,
795,368,427,20067,55432.0,57924.0,,,,53988.0,3212,712,3069,744,6281,1456,20067,,,20067,,
597,252,345,20069,61000.0,60318.0,,,,42656.0,2642,321,2664,352,5306,673,20069,,,20069,,
97,38,59,20071,47750.0,46776.0,,,,35000.0,558,45,560,33,1118,78,20071,,,20071,,
945,408,537,20073,38838.0,38914.0,,,,,2702,374,2828,399,5530,773,20073,,,20073,52.3,6.0
371,137,234,20075,45114.0,48344.0,,,,32208.0,1002,340,1020,224,2022,564,20075,,,20075,,
933,443,490,20077,43973.0,43438.0,,60417.0,,,2493,375,2511,324,5004,699,20077,,,20077,53.0,5.0
4415,1785,2630,20079,51327.0,51911.0,,,,39245.0,15195,1596,15987,1423,31182,3019,20079,,,20079,41.4,20.0
562,269,293,20081,56484.0,60306.0,,46250.0,,37067.0,1728,327,1622,400,3350,727,20081,,,20081,,
88,44,44,20083,54856.0,54471.0,,,,54167.0,865,95,859,85,1724,180,20083,,,20083,,
1197,414,783,20085,54077.0,56259.0,37188.0,27750.0,51339.0,41250.0,6111,488,6198,475,12309,963,20085,,,20085,56.1,10.0
1394,592,802,20087,57236.0,57274.0,,70192.0,,38750.0,8420,1072,8561,588,16981,1660,20087,,,20087,47.7,12.0
466,200,266,20089,40553.0,40865.0,,42500.0,,29250.0,1408,98,1412,93,2820,191,20089,,,20089,55.2,3.0
34556,14939,19617,20091,76113.0,77708.0,48930.0,72500.0,90328.0,46167.0,253715,21313,268130,19380,521845,40693,20091,,,20091,39.6,210.0
412,196,216,20093,50506.0,59479.0,,,,46429.0,1894,190,1603,189,3497,379,20093,,,20093,71.7,3.0
811,289,522,20095,50844.0,50812.0,,41071.0,,29135.0,3363,510,3365,401,6728,911,20095,,,20095,26.5,3.0
364,177,187,20097,43963.0,43628.0,,48750.0,,43889.0,1075,144,1155,93,2230,237,20097,,,20097,,
3651,1642,2009,20099,41439.0,42522.0,17328.0,36964.0,,25500.0,8898,1349,9121,1373,18019,2722,20099,,,20099,56.1,16.0
149,45,104,20101,56507.0,56728.0,,,,,741,67,805,52,1546,119,20101,,,20101,,
8223,3686,4537,20103,63726.0,65978.0,49443.0,62292.0,92727.0,62431.0,32327,2740,33288,2774,65615,5514,20103,,,20103,48.3,37.0
333,139,194,20105,44276.0,43684.0,,,,18438.0,1345,193,1349,201,2694,394,20105,,,20105,,
1246,607,639,20107,46964.0,46867.0,56316.0,75441.0,,24282.0,4196,420,4367,475,8563,895,20107,,,20107,65.1,10.0
232,98,134,20109,46875.0,49091.0,,,,76250.0,1279,115,1235,124,2514,239,20109,,,20109,,
6919,3172,3747,20111,40021.0,41085.0,,31442.0,24750.0,38903.0,13655,2404,14734,2256,28389,4660,20111,,,20111,53.3,19.0
1993,704,1289,20113,56128.0,56393.0,,52039.0,41228.0,57692.0,13319,954,13403,941,26722,1895,20113,,,20113,34.4,15.0
1306,620,686,20115,45927.0,46554.0,45714.0,29559.0,,,5517,413,5490,528,11007,941,20115,,,20115,26.8,5.0
1087,407,680,20117,45374.0,45465.0,,,,43542.0,4446,437,4569,366,9015,803,20117,,,20117,37.5,6.0
481,174,307,20119,52250.0,53025.0,,,,39792.0,1927,259,1852,218,3779,477,20119,,,20119,,
2949,1213,1736,20121,60966.0,61602.0,43971.0,,2499.0,55885.0,14560,1227,15190,1119,29750,2346,20121,,,20121,41.0,15.0
626,227,399,20123,48217.0,48975.0,,,,14000.0,2831,305,2845,162,5676,467,20123,,,20123,45.4,5.0
6303,2948,3355,20125,41083.0,42705.0,15932.0,37470.0,,34886.0,14212,2402,14815,2214,29027,4616,20125,,,20125,64.4,30.0
505,229,276,20127,47089.0,47743.0,,,,46250.0,2547,272,2581,269,5128,541,20127,,,20127,51.3,5.0
325,151,174,20129,46028.0,47306.0,,,,42097.0,1437,159,1256,162,2693,321,20129,,,20129,,
1129,473,656,20131,48653.0,49292.0,28523.0,21875.0,,53281.0,4754,294,4557,285,9311,579,20131,,,20131,29.6,5.0
2961,1306,1655,20133,43195.0,43450.0,,,,24583.0,7189,752,7269,985,14458,1737,20133,,,20133,49.7,11.0
354,217,137,20135,44904.0,44778.0,,,,32788.0,1414,122,1381,103,2795,225,20135,,,20135,,
398,166,232,20137,47852.0,47542.0,,,,,2224,186,2154,190,4378,376,20137,,,20137,,
1997,852,1145,20139,49915.0,50514.0,,,,40060.0,7134,817,7005,918,14139,1735,20139,,,20139,61.8,14.0
564,232,332,20141,40216.0,39844.0,,,,,1640,184,1669,184,3309,368,20141,,,20141,,
466,217,249,20143,52479.0,53021.0,,,,67596.0,2770,302,2607,274,5377,576,20143,,,20143,46.4,4.0
464,179,285,20145,43250.0,43844.0,,,,,2766,249,2489,396,5255,645,20145,,,20145,33.2,3.0
494,207,287,20147,44170.0,44236.0,,43750.0,,43295.0,2423,223,2562,175,4985,398,20147,,,20147,56.3,5.0
1992,859,1133,20149,60216.0,60330.0,88780.0,71912.0,51591.0,41500.0,10062,828,10455,805,20517,1633,20149,,,20149,39.2,9.0
1144,511,633,20151,49550.0,51250.0,,,,46894.0,4211,523,4352,446,8563,969,20151,,,20151,46.2,7.0
250,108,142,20153,41579.0,41480.0,,,,,1187,101,1118,98,2305,199,20153,,,20153,,
7457,3277,4180,20155,45288.0,45391.0,51612.0,50750.0,65750.0,39123.0,26523,3668,27232,4141,53755,7809,20155,,,20155,51.4,45.0
599,248,351,20157,40449.0,40740.0,,,,55250.0,2133,203,2218,154,4351,357,20157,,,20157,49.0,4.0
1365,641,724,20159,48460.0,49547.0,23947.0,46667.0,2499.0,52935.0,4223,745,4250,598,8473,1343,20159,,,20159,62.7,9.0
14922,7227,7695,20161,44437.0,45612.0,47893.0,22517.0,30675.0,33583.0,31274,2654,32321,2074,63595,4728,20161,,,20161,45.2,20.0
723,367,356,20163,43558.0,43269.0,,,,28958.0,2137,288,2378,226,4515,514,20163,,,20163,,
292,123,169,20165,38854.0,39063.0,,,,,1432,145,1395,146,2827,291,20165,,,20165,,
885,442,443,20167,41102.0,41858.0,,,,38750.0,3127,317,3121,299,6248,616,20167,,,20167,39.9,5.0
8700,3648,5052,20169,47801.0,48491.0,33438.0,20425.0,75547.0,31574.0,23383,3739,24630,3181,48013,6920,20169,,,20169,51.8,35.0
319,104,215,20171,51850.0,51868.0,,,,,2104,261,2409,73,4513,334,20171,,,20171,,
75400,34214,41186,20173,50657.0,53837.0,29097.0,42793.0,53291.0,36978.0,211273,35167,222649,30991,433922,66158,20173,,,20173,50.3,251.0
4350,1771,2579,20175,47134.0,47277.0,36429.0,72386.0,57434.0,44024.0,9273,2448,9295,2050,18568,4498,20175,,,20175,37.1,7.0
26445,12850,13595,20177,50378.0,52449.0,27617.0,46600.0,61607.0,40216.0,74433,10865,81597,8636,156030,19501,20177,,,20177,49.9,109.0
165,49,116,20179,49750.0,50406.0,,,,35673.0,1194,108,1070,130,2264,238,20179,,,20179,,
1125,605,520,20181,39029.0,39757.0,,,,25873.0,2553,368,2754,325,5307,693,20181,,,20181,51.6,5.0
543,207,336,20183,43848.0,43992.0,,,,72875.0,1693,115,1754,120,3447,235,20183,,,20183,61.9,4.0
675,351,324,20185,47377.0,47905.0,,,,36500.0,1821,295,1823,273,3644,568,20185,,,20185,,
113,41,72,20187,43780.0,52500.0,,,,32083.0,851,125,1027,110,1878,235,20187,,,20187,,
1037,423,614,20189,55433.0,60795.0,,42917.0,,41719.0,2384,498,2327,489,4711,987,20189,,,20189,,
2869,1134,1735,20191,50141.0,50423.0,,,2499.0,54241.0,10137,1312,10578,1128,20715,2440,20191,,,20191,49.9,15.0
733,337,396,20193,48504.0,49375.0,,,,35096.0,3626,233,3656,294,7282,527,20193,,,20193,,
119,54,65,20195,54000.0,54000.0,,,,41250.0,1290,135,1354,99,2644,234,20195,,,20195,,
404,149,255,20197,54688.0,54555.0,,,,48500.0,3155,327,3179,233,6334,560,20197,,,20197,,
129,54,75,20199,47279.0,47426.0,,,,53750.0,662,119,737,59,1399,178,20199,,,20199,,
649,265,384,20201,45159.0,45099.0,,,,31875.0,2552,262,2526,213,5078,475,20201,,,20201,42.7,4.0
214,122,92,20203,57171.0,56711.0,,,,38000.0,1003,143,857,177,1860,320,20203,,,20203,,
1639,813,826,20205,40306.0,40699.0,,31667.0,114250.0,28750.0,3690,733,3839,673,7529,1406,20205,,,20205,36.5,5.0
714,328,386,20207,35787.0,36019.0,,,,,1367,222,1303,295,2670,517,20207,,,20207,75.6,4.0
37963,17111,20852,20209,40113.0,44543.0,30800.0,32054.0,32917.0,35763.0,59633,19059,64007,16905,123640,35964,20209,,,20209,67.4,99.0
3789,1677,2112,21001,33362.0,34163.0,,,,,7610,1513,8237,1191,15847,2704,21001,91.2,21.0,21001,64.5,15.0
3454,1622,1832,21003,41326.0,40762.0,,,,,8287,1643,8621,1617,16908,3260,21003,82.9,20.0,21003,67.8,17.0
2223,1071,1152,21005,53974.0,54574.0,43250.0,,,,9563,1019,10211,858,19774,1877,21005,95.1,23.0,21005,78.0,18.0
1295,521,774,21007,42244.0,44026.0,28250.0,9583.0,,58375.0,3513,513,3619,481,7132,994,21007,94.3,11.0,21007,76.1,9.0
8598,3891,4707,21009,38370.0,38803.0,23452.0,,163583.0,29718.0,17754,2806,19037,2579,36791,5385,21009,106.9,58.0,21009,73.0,40.0
3122,1519,1603,21011,33483.0,33913.0,21125.0,,,,5097,829,5211,745,10308,1574,21011,109.0,16.0,21011,77.4,11.0
10233,4422,5811,21013,22443.0,22493.0,17574.0,,50227.0,,11077,1888,12279,1896,23356,3784,21013,99.5,37.0,21013,73.9,28.0
10156,4171,5985,21015,66730.0,66614.0,57158.0,,75257.0,43333.0,55944,4960,58053,4777,113997,9737,21015,86.0,90.0,21015,60.1,63.0
3272,1367,1905,21017,45208.0,46782.0,26438.0,,,42330.0,8272,1468,8907,1125,17179,2593,21017,93.4,24.0,21017,56.2,14.0
9500,3956,5544,21019,42319.0,42632.0,15484.0,,165114.0,,19500,2989,21652,2664,41152,5653,21019,92.7,61.0,21019,65.3,43.0
4291,1972,2319,21021,39704.0,40278.0,27109.0,,,24010.0,11987,1657,13140,1313,25127,2970,21021,77.6,29.0,21021,56.9,21.0
1544,695,849,21023,36327.0,36469.0,,,,,3834,355,3880,312,7714,667,21023,120.6,12.0,21023,92.7,9.0
4366,2095,2271,21025,25817.0,25635.0,,,123750.0,,5669,1065,6027,683,11696,1748,21025,105.7,18.0,21025,73.2,13.0
3422,1525,1897,21027,43479.0,44482.0,16250.0,,,42031.0,8348,1409,8807,1218,17155,2627,21027,110.2,29.0,21027,80.0,21.0
7911,3531,4380,21029,55975.0,56590.0,,,54286.0,63177.0,34539,3232,36542,2294,71081,5526,21029,90.9,70.0,21029,59.8,44.0
3667,1636,2031,21031,33536.0,33086.0,,,,,5530,791,5527,772,11057,1563,21031,87.2,14.0,21031,76.6,12.0
2544,1119,1425,21033,42537.0,42894.0,36324.0,,,,5306,847,5982,565,11288,1412,21033,103.9,19.0,21033,88.0,16.0
8015,3642,4373,21035,37034.0,38851.0,28405.0,2499.0,2499.0,19406.0,15956,2145,17401,2162,33357,4307,21035,79.1,35.0,21035,57.1,25.0
12883,5671,7212,21037,54621.0,55738.0,19531.0,,92829.0,24258.0,39050,4835,41623,4503,80673,9338,21037,94.5,93.0,21037,67.3,65.0
970,388,582,21039,38829.0,38934.0,25357.0,,,82829.0,1999,371,2234,310,4233,681,21039,95.2,7.0,21039,61.5,5.0
2898,1409,1489,21041,41439.0,42291.0,14891.0,,,23077.0,4547,926,4343,777,8890,1703,21041,120.7,15.0,21041,69.9,9.0
4682,2153,2529,21043,36696.0,36814.0,,,,19178.0,11205,2107,11721,1979,22926,4086,21043,103.0,35.0,21043,73.5,25.0
3969,1878,2091,21045,32341.0,32644.0,26607.0,,,,6323,1419,6646,1235,12969,2654,21045,108.6,23.0,21045,98.5,21.0
13576,5438,8138,21047,39521.0,42874.0,26444.0,22969.0,55417.0,28214.0,26112,4412,30171,4471,56283,8883,21047,84.9,53.0,21047,62.4,39.0
5401,2194,3207,21049,47959.0,48616.0,27044.0,,98438.0,27404.0,15217,1994,16084,1937,31301,3931,21049,93.4,40.0,21049,67.4,29.0
7732,3730,4002,21051,21549.0,21444.0,23625.0,57500.0,,,8527,1318,8879,920,17406,2238,21051,118.6,28.0,21051,96.5,22.0
2435,1078,1357,21053,28025.0,28225.0,,,,16786.0,4184,760,4569,523,8753,1283,21053,111.7,16.0,21053,80.5,11.0
1974,950,1024,21055,35316.0,35693.0,14091.0,,,,3763,740,3854,671,7617,1411,21055,76.6,10.0,21055,78.8,10.0
1682,652,1030,21057,32019.0,32294.0,21786.0,,,,2711,582,2831,595,5542,1177,21057,96.4,10.0,21057,67.9,7.0
14948,6723,8225,21059,45989.0,47450.0,24767.0,26250.0,37083.0,27500.0,41744,4990,45640,4058,87384,9048,21059,110.2,130.0,21059,78.1,92.0
2296,971,1325,21061,41710.0,41794.0,,,,,5339,723,5522,424,10861,1147,21061,85.6,14.0,21061,70.5,12.0
2079,1023,1056,21063,28224.0,28257.0,,,,,2965,413,2916,409,5881,822,21063,73.8,8.0,21063,58.5,6.0
4199,1957,2242,21065,29770.0,29778.0,,,,,5958,1112,6469,811,12427,1923,21065,124.6,24.0,21065,83.5,16.0
55900,26117,29783,21067,49778.0,55636.0,28366.0,35234.0,65154.0,34907.0,128848,18757,140094,15307,268942,34064,21067,74.0,206.0,21067,52.2,145.0
2907,1232,1675,21069,35469.0,35681.0,,,,,5735,1444,6113,1252,11848,2696,21069,90.5,16.0,21069,61.1,11.0
11441,5471,5970,21071,30096.0,30073.0,,53929.0,250001.0,,15672,3017,17076,2325,32748,5342,21071,149.4,73.0,21071,98.7,47.0
6990,3195,3795,21073,47964.0,50529.0,38305.0,,64569.0,27440.0,20632,3089,23049,2051,43681,5140,21073,93.0,56.0,21073,75.9,45.0
1641,763,878,21075,28359.0,33682.0,15731.0,,,27250.0,2477,379,2656,480,5133,859,21075,112.4,11.0,21075,88.9,9.0
1294,589,705,21077,48370.0,49114.0,,,,40139.0,3653,584,3569,651,7222,1235,21077,104.0,9.0,21077,83.8,8.0
3653,1729,1924,21079,44243.0,44417.0,30966.0,,,37206.0,7132,1188,7409,1144,14541,2332,21079,97.8,21.0,21079,79.6,16.0
4445,1914,2531,21081,44824.0,44193.0,,,,85060.0,10735,1268,10822,1419,21557,2687,21081,95.8,23.0,21081,64.4,15.0
6342,2715,3627,21083,39530.0,41790.0,16333.0,,,38474.0,15937,2107,16799,2228,32736,4335,21083,85.8,43.0,21083,72.8,36.0
6119,2731,3388,21085,35030.0,35438.0,,,,,10962,1730,11130,1779,22092,3509,21085,129.7,43.0,21085,87.9,28.0
2216,1047,1169,21087,34982.0,36113.0,,,,,4766,672,5029,568,9795,1240,21087,86.4,14.0,21087,68.4,11.0
6355,2848,3507,21089,45370.0,45577.0,,,131136.0,71176.0,15041,2504,16463,2045,31504,4549,21089,107.4,54.0,21089,71.9,36.0
1360,654,706,21091,50476.0,50420.0,58594.0,,,,4054,375,3828,357,7882,732,21091,81.9,9.0,21091,81.4,9.0
14886,5818,9068,21093,50765.0,50156.0,55642.0,,64167.0,51656.0,43690,5003,48278,4751,91968,9754,21093,101.5,104.0,21093,69.3,71.0
8661,3763,4898,21095,25814.0,25892.0,23417.0,15833.0,250001.0,,11532,2065,12330,1993,23862,4058,21095,127.6,48.0,21095,95.3,34.0
4069,1749,2320,21097,35681.0,36803.0,,,,30259.0,7525,1511,8119,1289,15644,2800,21097,95.8,23.0,21097,65.1,15.0
4507,2082,2425,21099,34774.0,35542.0,20000.0,,,41806.0,7399,1564,7956,1268,15355,2832,21099,114.5,27.0,21099,90.2,21.0
8602,3810,4792,21101,41036.0,42762.0,24167.0,,59318.0,36625.0,19221,2564,21419,2224,40640,4788,21101,97.8,54.0,21101,67.5,38.0
2798,1226,1572,21103,46495.0,46990.0,29773.0,,,,6875,815,6811,876,13686,1691,21103,109.3,21.0,21103,89.3,17.0
675,284,391,21105,41218.0,42468.0,23250.0,,,,1822,351,2083,264,3905,615,21105,80.0,6.0,21105,66.4,5.0
7799,3301,4498,21107,42346.0,43829.0,28750.0,,,51458.0,19300,2689,20665,2855,39965,5544,21107,89.9,55.0,21107,66.6,41.0
4163,1963,2200,21109,29826.0,29925.0,,,,,5322,1225,5727,931,11049,2156,21109,118.3,20.0,21109,104.6,17.0
121683,54397,67286,21111,48695.0,54330.0,29245.0,50214.0,64884.0,39010.0,317681,42529,350615,36744,668296,79273,21111,89.6,759.0,21111,60.5,512.0
9190,4128,5062,21113,50558.0,51302.0,32083.0,43750.0,,30809.0,21214,2952,22975,2609,44189,5561,21113,89.0,44.0,21113,59.7,29.0
5977,2721,3256,21115,35570.0,35482.0,,,111250.0,2499.0,9812,1282,10624,1189,20436,2471,21115,113.0,33.0,21115,92.5,27.0
23432,10164,13268,21117,54296.0,56285.0,24928.0,18688.0,53750.0,45236.0,70758,8846,74031,7822,144789,16668,21117,90.3,145.0,21117,65.0,102.0
4308,1935,2373,21119,30411.0,30757.0,23333.0,,,,6791,1117,6837,1073,13628,2190,21119,116.1,23.0,21119,85.9,17.0
10093,4551,5542,21121,26599.0,26499.0,38750.0,,,33526.0,13099,2244,14164,1956,27263,4200,21121,125.0,50.0,21121,85.9,33.0
2460,1058,1402,21123,38578.0,39216.0,33631.0,,,,5839,934,6563,531,12402,1465,21123,74.6,14.0,21123,60.6,11.0
13588,6216,7372,21125,36020.0,35971.0,,26071.0,60405.0,42661.0,24302,4516,26170,4023,50472,8539,21125,89.1,61.0,21125,74.4,50.0
3548,1619,1929,21127,35935.0,36222.0,,,,63224.0,7013,812,6685,1199,13698,2011,21127,113.9,22.0,21127,85.1,16.0
2003,952,1051,21129,22698.0,22759.0,,,,,2586,375,2853,480,5439,855,21129,117.7,11.0,21129,90.8,9.0
3051,1360,1691,21131,25872.0,26399.0,,,,,4705,562,4739,743,9444,1305,21131,151.8,22.0,21131,110.3,16.0
6614,3158,3456,21133,30333.0,30367.0,,,,,10039,1495,10330,1616,20369,3111,21133,118.5,37.0,21133,96.1,29.0
4151,1885,2266,21135,28630.0,28691.0,,,,,5802,997,5818,1025,11620,2022,21135,112.6,19.0,21135,84.1,14.0
6039,2656,3383,21137,37139.0,37109.0,36797.0,,,125194.0,9829,1898,10872,1688,20701,3586,21137,98.5,31.0,21137,71.6,22.0
1362,518,844,21139,42171.0,41909.0,,,,,4161,471,4367,333,8528,804,21139,113.1,16.0,21139,81.6,12.0
5103,2411,2692,21141,38570.0,40257.0,18370.0,,,,11222,1890,11565,1903,22787,3793,21141,103.5,36.0,21141,77.8,26.0
1002,340,662,21143,46931.0,46921.0,,,,,3120,448,3167,326,6287,774,21143,86.4,12.0,21143,59.5,8.0
10763,4614,6149,21145,44067.0,46536.0,25146.0,,95455.0,37162.0,27284,3471,30304,3202,57588,6673,21145,80.9,72.0,21145,55.6,49.0
6723,3259,3464,21147,19328.0,19340.0,,,,,7222,1104,7267,829,14489,1933,21147,157.5,31.0,21147,111.1,22.0
1983,1026,957,21149,40770.0,41250.0,53250.0,,,31250.0,4194,482,4270,470,8464,952,21149,101.7,14.0,21149,68.1,9.0
16792,7821,8971,21151,42390.0,43664.0,20463.0,,47132.0,28967.0,36288,4892,39492,4355,75780,9247,21151,91.6,76.0,21151,73.8,60.0
3672,1659,2013,21153,28500.0,28467.0,,,,,5506,977,5635,760,11141,1737,21153,109.7,16.0,21153,73.0,10.0
3784,1646,2138,21155,38826.0,40385.0,22004.0,,56765.0,36354.0,8105,1031,8714,824,16819,1855,21155,100.8,22.0,21155,69.1,15.0
3287,1524,1763,21157,45212.0,45610.0,,,,41932.0,13550,1520,14546,1045,28096,2565,21157,82.9,40.0,21157,60.9,29.0
3896,1753,2143,21159,25795.0,25940.0,,,,,4729,908,4720,774,9449,1682,21159,145.1,20.0,21159,109.1,14.0
3087,1549,1538,21161,38824.0,40041.0,20365.0,,,,7261,1066,7844,818,15105,1884,21161,123.7,27.0,21161,86.6,19.0
4810,2187,2623,21163,49884.0,50524.0,39609.0,,,57383.0,12110,1836,12590,1681,24700,3517,21163,118.1,33.0,21163,87.0,24.0
1851,917,934,21165,31503.0,32037.0,,,,,2721,532,2695,318,5416,850,21165,124.6,11.0,21165,106.0,9.0
3862,1709,2153,21167,42083.0,42638.0,41429.0,,,69500.0,9137,1331,9758,955,18895,2286,21167,93.3,27.0,21167,67.2,19.0
2158,932,1226,21169,32294.0,33458.0,17292.0,,,30893.0,4014,895,4198,784,8212,1679,21169,107.7,15.0,21169,84.0,11.0
2937,1363,1574,21171,31045.0,30870.0,39539.0,,,31442.0,4672,576,4805,542,9477,1118,21171,106.8,16.0,21171,84.3,12.0
6956,3141,3815,21173,39275.0,39172.0,29079.0,,,,11234,1995,11766,1813,23000,3808,21173,94.8,29.0,21173,68.7,21.0
3249,1464,1785,21175,29707.0,29946.0,,,,,5158,690,5295,629,10453,1319,21175,98.9,16.0,21175,81.5,13.0
6000,2750,3250,21177,38961.0,39846.0,22715.0,,,,12821,2172,13643,1647,26464,3819,21177,102.6,42.0,21177,77.3,32.0
7072,3347,3725,21179,49298.0,50470.0,28939.0,25833.0,55962.0,11462.0,19866,2005,20379,2020,40245,4025,21179,90.4,42.0,21179,64.2,30.0
1624,754,870,21181,36097.0,36763.0,23750.0,,,,2885,545,2979,560,5864,1105,21181,106.5,10.0,21181,89.6,8.0
5208,2466,2742,21183,40189.0,39814.0,,,,44250.0,10653,1198,10556,1345,21209,2543,21183,124.8,38.0,21183,94.6,28.0
3503,1271,2232,21185,85452.0,85894.0,81250.0,65690.0,167344.0,49375.0,27429,1803,28212,1375,55641,3178,21185,77.2,43.0,21185,51.6,27.0
1780,810,970,21187,41934.0,42342.0,36574.0,,,35417.0,4806,448,4930,508,9736,956,21187,91.2,12.0,21187,50.6,7.0
1710,810,900,21189,20985.0,20618.0,,,,,1879,247,2108,300,3987,547,21189,148.1,9.0,21189,118.5,8.0
2188,875,1313,21191,48353.0,49368.0,,,,93693.0,6614,595,6570,639,13184,1234,21191,97.9,16.0,21191,67.4,11.0
6894,2903,3991,21193,32667.0,31911.0,93000.0,,,,11544,1921,11982,1944,23526,3865,21193,139.7,49.0,21193,125.6,43.0
14256,6146,8110,21195,33183.0,32965.0,41821.0,,,30147.0,26905,3723,28765,3303,55670,7026,21195,123.0,98.0,21195,85.4,67.0
3392,1361,2031,21197,29736.0,30476.0,,,,16688.0,5131,829,5551,714,10682,1543,21197,152.9,23.0,21197,125.3,18.0
16497,7900,8597,21199,34790.0,34838.0,27907.0,77782.0,43906.0,18510.0,26787,3975,28664,3411,55451,7386,21199,93.6,80.0,21199,74.7,63.0
473,215,258,21201,31741.0,31830.0,,,,,1004,78,946,119,1950,197,21201,111.8,4.0,21201,,
4105,1907,2198,21203,31555.0,31778.0,,,,,7221,929,7651,843,14872,1772,21203,118.1,25.0,21203,89.2,19.0
5410,2340,3070,21205,36860.0,35812.0,41224.0,,,,9643,1561,10476,1707,20119,3268,21205,92.4,22.0,21205,69.6,16.0
4475,2055,2420,21207,30720.0,30930.0,41500.0,,,,7313,1270,7645,1297,14958,2567,21207,102.4,25.0,21207,84.1,21.0
5332,2152,3180,21209,63027.0,65456.0,40868.0,,74625.0,34120.0,22340,2276,22960,2365,45300,4641,21209,87.3,37.0,21209,59.5,24.0
5566,2671,2895,21211,60324.0,61765.0,40270.0,,,28833.0,18124,3024,19538,2289,37662,5313,21211,76.6,36.0,21211,47.8,22.0
3473,1486,1987,21213,39679.0,45173.0,25527.0,,,8657.0,7182,1324,7973,907,15155,2231,21213,106.5,22.0,21213,81.7,17.0
1466,577,889,21215,63000.0,63492.0,91140.0,,,60577.0,8119,615,8069,651,16188,1266,21215,84.8,15.0,21215,59.0,10.0
5658,2390,3268,21217,33340.0,33879.0,25887.0,,,,9975,1923,11125,1615,21100,3538,21217,100.2,32.0,21217,81.6,26.0
2277,927,1350,21219,40497.0,42892.0,29779.0,,,,4872,1197,4982,1241,9854,2438,21219,83.1,12.0,21219,65.1,9.0
2500,1030,1470,21221,44083.0,45793.0,23917.0,,,57692.0,5665,1274,6222,1005,11887,2279,21221,94.6,20.0,21221,80.6,17.0
1486,737,749,21223,47409.0,47091.0,,,,51810.0,3727,636,3934,486,7661,1122,21223,113.2,12.0,21223,91.9,9.0
4091,2171,1920,21225,40120.0,41385.0,18750.0,,,41250.0,6386,1340,6497,760,12883,2100,21225,106.4,17.0,21225,78.2,13.0
21047,9159,11888,21227,44911.0,48292.0,31564.0,58558.0,38750.0,35335.0,49575,7636,54292,6175,103867,13811,21227,91.3,100.0,21227,65.5,70.0
2034,969,1065,21229,40976.0,42935.0,34429.0,,,12222.0,5190,641,5345,609,10535,1250,21229,80.5,12.0,21229,60.6,9.0
5477,2505,2972,21231,28573.0,29326.0,,,,13966.0,8652,1393,9154,1148,17806,2541,21231,101.7,28.0,21231,79.5,22.0
2296,1117,1179,21233,38917.0,39085.0,36806.0,,,31528.0,5656,845,5850,713,11506,1558,21233,109.1,19.0,21233,73.7,13.0
8871,4030,4841,21235,31014.0,31014.0,16346.0,102778.0,,,14768,2377,15823,2205,30591,4582,21235,122.4,50.0,21235,95.6,39.0
3058,1537,1521,21237,20504.0,20818.0,,,,,3089,443,3194,410,6283,853,21237,118.3,11.0,21237,77.6,7.0
3259,1279,1980,21239,58750.0,60568.0,37000.0,,,33803.0,10802,1350,12086,961,22888,2311,21239,68.2,20.0,21239,51.9,15.0
12539,4702,7837,22001,37649.0,43239.0,20742.0,,,30893.0,25052,4501,26321,5380,51373,9881,22001,79.6,53.0,22001,68.6,46.0
3501,1568,1933,22003,40948.0,43537.0,25798.0,43095.0,,46250.0,9085,1517,9271,1456,18356,2973,22003,71.2,19.0,22003,58.4,16.0
13447,5551,7896,22005,70551.0,75232.0,49888.0,,70755.0,56400.0,49740,6573,51245,6347,100985,12920,22005,68.6,63.0,22005,58.8,51.0
3643,1673,1970,22007,49167.0,60572.0,24904.0,,,33185.0,9365,1730,10035,1732,19400,3462,22007,77.8,21.0,22007,62.9,17.0
8750,3408,5342,22009,33739.0,39339.0,22760.0,,,,14267,3471,16338,3711,30605,7182,22009,85.2,42.0,22009,66.7,33.0
7137,3103,4034,22011,45969.0,49349.0,26719.0,64375.0,80493.0,,14324,3286,14852,2707,29176,5993,22011,76.4,30.0,22011,59.5,23.0
3754,1397,2357,22013,32876.0,45332.0,21335.0,,,,5355,1163,6032,1103,11387,2266,22013,82.0,16.0,22013,63.3,12.0
17303,7402,9901,22015,52892.0,59888.0,31217.0,70060.0,53825.0,53147.0,49219,7780,53840,7722,103059,15502,22015,75.3,91.0,22015,54.1,65.0
53752,23393,30359,22017,41234.0,57236.0,28614.0,26875.0,49009.0,39948.0,98254,19517,111467,20545,209721,40062,22017,69.0,201.0,22017,54.8,159.0
32864,13822,19042,22019,45312.0,52272.0,28838.0,60859.0,57054.0,44375.0,78600,15365,84661,14896,163261,30261,22019,68.4,145.0,22019,58.1,121.0
2053,876,1177,22021,33294.0,37833.0,15453.0,,,21190.0,3588,1273,3742,909,7330,2182,22021,95.2,12.0,22021,76.8,10.0
650,317,333,22023,64231.0,64885.0,,,,,2885,375,3098,336,5983,711,22023,64.1,5.0,22023,42.4,3.0
1890,872,1018,22025,34904.0,44702.0,17963.0,,,,3492,1086,3512,1194,7004,2280,22025,93.0,12.0,22025,66.1,8.0
4058,2023,2035,22027,32072.0,48579.0,17567.0,54167.0,,,6309,1419,5875,1103,12184,2522,22027,69.5,15.0,22027,44.2,10.0
5598,2400,3198,22029,29654.0,43488.0,16636.0,,,,6436,2106,6914,2963,13350,5069,22029,76.7,19.0,22029,59.6,15.0
7059,3061,3998,22031,41468.0,51319.0,22397.0,61167.0,,,10910,1898,11889,2111,22799,4009,22031,80.7,27.0,22031,52.7,18.0
85254,37081,48173,22033,49285.0,66598.0,34646.0,40682.0,58869.0,50208.0,182247,29615,203061,26795,385308,56410,22033,56.4,240.0,22033,46.9,199.0
2903,1374,1529,22035,21099.0,42083.0,16364.0,,,,2184,704,2549,627,4733,1331,22035,98.0,8.0,22035,72.6,6.0
3317,1569,1748,22037,45520.0,54260.0,33384.0,,,,7029,1171,7838,1130,14867,2301,22037,61.1,15.0,22037,60.4,14.0
8373,3718,4655,22039,30009.0,41474.0,14524.0,,,20650.0,12886,2366,14036,2317,26922,4683,22039,81.8,30.0,22039,70.6,26.0
5847,2294,3553,22041,30275.0,36693.0,17648.0,,,,6763,2057,8079,2208,14842,4265,22041,77.2,21.0,22041,47.9,13.0
3460,1459,2001,22043,39914.0,41059.0,21862.0,54125.0,,,7766,1456,8385,1330,16151,2786,22043,100.8,24.0,22043,71.7,16.0
14277,6094,8183,22045,45261.0,54047.0,30554.0,70588.0,66711.0,46821.0,29216,6262,31899,5736,61115,11998,22045,78.2,60.0,22045,66.3,50.0
5612,2473,3139,22047,45117.0,59344.0,33257.0,,,,12326,2175,13307,1618,25633,3793,22047,92.2,34.0,22047,67.0,24.0
3981,1799,2182,22049,38029.0,43852.0,21594.0,,,,6201,1155,6669,1008,12870,2163,22049,80.5,18.0,22049,70.7,15.0
72319,30773,41546,22051,47947.0,54354.0,34002.0,39531.0,60511.0,40995.0,170170,38834,190812,31948,360982,70782,22051,67.4,340.0,22051,52.3,262.0
6462,2713,3749,22053,39063.0,44171.0,20053.0,20848.0,,16750.0,13196,1961,13402,2304,26598,4265,22053,81.8,31.0,22053,70.1,27.0
36346,15225,21121,22055,51869.0,61544.0,29224.0,132588.0,60802.0,44336.0,95586,16284,100459,17188,196045,33472,22055,69.9,145.0,22055,52.0,107.0
14117,5730,8387,22057,51030.0,54243.0,28335.0,,70234.0,40318.0,40417,6919,42188,7112,82605,14031,22057,70.9,73.0,22057,59.9,62.0
2857,1184,1673,22059,37310.0,38953.0,18000.0,56601.0,,,5609,1111,5849,1087,11458,2198,22059,87.6,16.0,22059,62.3,11.0
14146,6360,7786,22061,33467.0,50425.0,20715.0,,36250.0,15995.0,18702,3888,20323,3822,39025,7710,22061,60.7,27.0,22061,45.9,20.0
19086,7960,11126,22063,58251.0,58708.0,41776.0,124076.0,,62868.0,54967,10265,58238,9526,113205,19791,22063,81.6,98.0,22063,66.4,77.0
3962,1840,2122,22065,23854.0,40903.0,16799.0,,,,3300,1738,3621,1747,6921,3485,22065,66.7,9.0,22065,41.3,5.0
7432,3212,4220,22067,28003.0,37849.0,20261.0,15938.0,80595.0,10733.0,9869,2442,11441,2459,21310,4901,22067,76.1,27.0,22067,52.7,18.0
11208,4921,6287,22069,31345.0,45440.0,20172.0,21250.0,89167.0,35893.0,15049,3127,16951,3484,32000,6611,22069,66.0,29.0,22069,52.7,23.0
98823,42998,55825,22071,36792.0,62490.0,25347.0,37875.0,46592.0,40232.0,144150,32246,167332,27871,311482,60117,22071,67.6,242.0,22071,53.4,185.0
36312,14458,21854,22073,37754.0,50757.0,22478.0,21303.0,61007.0,47136.0,55010,13804,65499,15045,120509,28849,22073,78.3,126.0,22073,62.0,99.0
3775,1348,2427,22075,50314.0,56288.0,34125.0,,,33197.0,9586,1469,10469,1260,20055,2729,22075,70.4,17.0,22075,51.6,12.0
4368,1876,2492,22077,43825.0,57022.0,24882.0,,,20724.0,8902,1807,9933,1729,18835,3536,22077,53.5,17.0,22077,44.1,13.0
26645,11724,14921,22079,40734.0,48821.0,26263.0,45208.0,31526.0,42311.0,51678,10140,57797,9853,109475,19993,22079,68.9,103.0,22079,53.7,81.0
1937,803,1134,22081,38000.0,45547.0,24770.0,,,,3476,734,3741,775,7217,1509,22081,57.9,6.0,22081,39.4,4.0
4154,1825,2329,22083,36421.0,47766.0,21617.0,,,41125.0,6428,3106,7524,2868,13952,5974,22083,79.0,19.0,22083,57.5,14.0
4626,1836,2790,22085,38828.0,44966.0,22283.0,31919.0,,30329.0,9729,2123,9862,2117,19591,4240,22085,66.5,23.0,22085,59.5,20.0
8209,3529,4680,22087,42753.0,46517.0,31497.0,44205.0,33313.0,36853.0,17811,3166,18950,2585,36761,5751,22087,97.4,33.0,22087,79.8,26.0
6152,2412,3740,22089,59990.0,70933.0,35125.0,,71375.0,59564.0,21539,3573,23413,3456,44952,7029,22089,71.2,36.0,22089,58.8,29.0
2854,1309,1545,22091,35437.0,50649.0,26136.0,,,,3913,1245,4593,943,8506,2188,22091,64.3,9.0,22091,67.1,9.0
3841,1845,1996,22093,51107.0,67689.0,33868.0,,,,8688,1575,9829,1335,18517,2910,22093,58.0,14.0,22093,53.3,13.0
7893,3390,4503,22095,50921.0,58359.0,45754.0,,,42308.0,17705,3182,19606,2968,37311,6150,22095,61.6,27.0,22095,56.3,25.0
22970,9790,13180,22097,32625.0,44394.0,19336.0,,,47591.0,33611,6006,36207,6717,69818,12723,22097,80.3,76.0,22097,61.2,58.0
9388,3920,5468,22099,42794.0,51701.0,30231.0,78750.0,23438.0,50147.0,22517,3509,22724,4110,45241,7619,22099,75.1,42.0,22099,61.5,34.0
11746,4967,6779,22101,40781.0,48906.0,25172.0,53080.0,49211.0,41365.0,20511,5130,22112,4804,42623,9934,22101,66.6,40.0,22101,53.4,33.0
27482,11568,15914,22103,62137.0,65539.0,39373.0,27065.0,80583.0,48173.0,100907,15203,110031,14275,210938,29478,22103,67.3,179.0,22103,51.5,135.0
26962,11734,15228,22105,41302.0,51528.0,25771.0,31356.0,,35920.0,49445,11132,54218,9950,103663,21082,22105,79.3,100.0,22105,62.4,77.0
1685,731,954,22107,22940.0,36550.0,15375.0,,,,1437,819,1794,707,3231,1526,22107,58.5,4.0,22107,58.6,4.0
21627,9182,12445,22109,47826.0,55365.0,28439.0,38821.0,46492.0,55000.0,45137,9743,47124,9504,92261,19247,22109,76.2,86.0,22109,57.1,64.0
6166,2682,3484,22111,34992.0,45232.0,17362.0,,,19237.0,9243,1520,9346,2002,18589,3522,22111,78.9,24.0,22111,73.6,22.0
10379,4185,6194,22113,45374.0,49875.0,22921.0,52552.0,39214.0,41042.0,23925,4489,26220,4020,50145,8509,22113,77.5,49.0,22113,56.5,36.0
7403,3280,4123,22115,46312.0,47358.0,39437.0,43750.0,60809.0,44740.0,19463,2999,21583,2744,41046,5743,22115,91.7,39.0,22115,72.1,30.0
11811,5364,6447,22117,30705.0,35372.0,20771.0,,,,17546,3722,19486,4016,37032,7738,22117,92.0,53.0,22117,67.4,39.0
9327,4117,5210,22119,33681.0,43822.0,19949.0,38125.0,68603.0,26103.0,15408,3646,17022,3617,32430,7263,22119,86.3,46.0,22119,55.6,30.0
4662,1883,2779,22121,53703.0,66266.0,31859.0,,65833.0,37422.0,9882,1667,11267,1171,21149,2838,22121,71.5,18.0,22121,54.9,13.0
2746,1066,1680,22123,31926.0,37430.0,19888.0,,,30938.0,3298,1763,3779,1842,7077,3605,22123,78.5,12.0,22123,70.8,11.0
1914,1016,898,22125,56685.0,85140.0,22232.0,,,,6066,805,4546,575,10612,1380,22125,80.1,14.0,22125,56.9,10.0
3466,1506,1960,22127,31087.0,40856.0,16917.0,,,,5058,1136,5731,1183,10789,2319,22127,80.3,15.0,22127,66.1,12.0
18392,8191,10201,25001,63251.0,64278.0,46864.0,35125.0,47115.0,60436.0,96016,5058,106883,4331,202899,9389,25001,60.0,247.0,25001,41.5,175.0
16038,6834,9204,25003,49956.0,50671.0,29258.0,21000.0,65063.0,45777.0,58717,2525,64310,1472,123027,3997,25003,70.0,135.0,25003,47.9,95.0
68016,29385,38631,25005,56842.0,59762.0,42267.0,28030.0,77000.0,28369.0,251666,12617,273204,8304,524870,20921,25005,72.9,476.0,25005,49.6,326.0
1970,802,1168,25007,64222.0,67545.0,40625.0,,65417.0,,7430,957,8134,416,15564,1373,25007,53.7,13.0,25007,42.2,10.0
85417,35457,49960,25009,69068.0,74466.0,46226.0,40160.0,85049.0,37182.0,346008,17841,381455,11050,727463,28891,25009,67.5,602.0,25009,43.3,390.0
8210,3508,4702,25011,55221.0,55818.0,36250.0,,44219.0,32333.0,32927,1385,35098,984,68025,2369,25011,52.1,50.0,25011,36.3,35.0
79308,34517,44791,25013,50461.0,56124.0,37149.0,17045.0,50595.0,22847.0,211241,11563,233061,6691,444302,18254,25013,67.8,368.0,25013,49.5,271.0
20317,9564,10753,25015,61368.0,62172.0,29178.0,,54318.0,47026.0,71865,2788,82499,2255,154364,5043,25015,52.5,90.0,25015,39.9,68.0
124958,53601,71357,25017,85118.0,87980.0,47720.0,59211.0,97198.0,49832.0,718895,30371,771113,20090,1490008,50461,25017,61.8,1031.0,25017,42.5,713.0
1205,657,548,25019,84057.0,88223.0,54745.0,,,88480.0,5049,506,4666,283,9715,789,25019,52.8,6.0,25019,42.7,5.0
44199,17778,26421,25021,88262.0,90667.0,63775.0,57500.0,89513.0,74641.0,315500,8590,348517,6448,664017,15038,25021,63.0,511.0,25021,42.8,354.0
40309,17589,22720,25023,75459.0,80187.0,43643.0,91528.0,82303.0,54528.0,230787,9501,249253,6633,480040,16134,25023,72.4,430.0,25023,49.6,292.0
148278,64005,84273,25025,55044.0,68686.0,38856.0,23804.0,40287.0,36030.0,339121,23427,375290,14000,714411,37427,25025,69.7,448.0,25025,45.6,292.0
92288,40222,52066,25027,65313.0,67708.0,43082.0,37309.0,81478.0,32751.0,375789,16106,397311,9771,773100,25877,25027,69.8,616.0,25027,50.1,439.0
11927,5722,6205,24001,40551.0,41115.0,19054.0,2499.0,,28571.0,30584,2908,32601,2070,63185,4978,24001,78.1,82.0,24001,45.7,48.0
31573,13598,17975,24003,89860.0,94882.0,74802.0,39755.0,100983.0,67667.0,240091,19346,260900,14834,500991,34180,24003,64.3,364.0,24003,50.1,277.0
75464,30881,44583,24005,67095.0,71270.0,58471.0,53173.0,77066.0,54937.0,349705,36042,399264,29786,748969,65828,24005,67.6,661.0,24005,47.8,471.0
5207,2044,3163,24009,95828.0,101893.0,63879.0,,103421.0,91333.0,40547,3060,42835,2344,83382,5404,24009,64.7,57.0,24009,49.4,43.0
5086,2254,2832,24011,52465.0,55892.0,30530.0,30476.0,46667.0,36500.0,13480,2162,15141,1486,28621,3648,24011,75.1,28.0,24011,56.7,22.0
9205,4085,5120,24013,85385.0,85355.0,77527.0,,110750.0,68867.0,77013,4409,80583,3425,157596,7834,24013,61.0,117.0,24013,47.9,90.0
10179,4664,5515,24015,66396.0,68674.0,46724.0,,53409.0,49919.0,45549,4270,47305,3698,92854,7968,24015,79.2,85.0,24015,64.4,69.0
11905,4933,6972,24017,90607.0,94431.0,84260.0,67750.0,116250.0,95779.0,67034,4660,75125,3317,142159,7977,24017,55.4,74.0,24017,47.1,61.0
5275,2146,3129,24019,47093.0,58862.0,28212.0,,75625.0,46490.0,13800,1515,15552,1228,29352,2743,24019,73.1,34.0,24019,62.0,29.0
16204,7194,9010,24021,83700.0,87069.0,64241.0,72361.0,74717.0,66260.0,108742,8968,114221,7176,222963,16144,24021,52.7,124.0,24021,40.6,95.0
3615,1673,1942,24023,45432.0,45404.0,,111250.0,65458.0,70972.0,12834,1649,13368,1480,26202,3129,24023,49.5,21.0,24023,46.3,19.0
19854,8342,11512,24025,80465.0,82674.0,61374.0,,82201.0,72233.0,113060,7086,120857,5276,233917,12362,24025,68.6,184.0,24025,49.9,131.0
15759,6684,9075,24027,110238.0,120146.0,86509.0,76435.0,114874.0,76619.0,137570,9750,145908,8370,283478,18120,24027,44.4,118.0,24027,28.8,74.0
2051,825,1226,24029,58147.0,61438.0,25233.0,,53550.0,57889.0,8298,942,9733,599,18031,1541,24029,61.1,20.0,24029,53.4,18.0
67820,28612,39208,24031,99435.0,114879.0,68759.0,63463.0,103872.0,67759.0,430903,54617,474753,48905,905656,103522,24031,35.4,371.0,24031,25.0,263.0
84018,36085,47933,24033,74260.0,77972.0,75021.0,59566.0,78504.0,60333.0,355547,69865,408095,52586,763642,122451,24033,46.6,361.0,24033,40.0,299.0
3588,1721,1867,24035,85963.0,89912.0,42852.0,,,82625.0,22094,1470,23452,999,45546,2469,24035,63.9,39.0,24035,47.1,27.0
8384,3098,5286,24037,86987.0,92783.0,47808.0,99167.0,98570.0,66250.0,48738,3615,51331,3219,100069,6834,24037,68.8,68.0,24037,54.0,52.0
4681,1834,2847,24039,35154.0,40613.0,29381.0,,37250.0,26594.0,8510,1033,10465,1225,18975,2258,24039,95.9,29.0,24039,70.4,21.0
4202,1493,2709,24041,58228.0,65670.0,31063.0,,53953.0,36165.0,15681,1921,18088,1719,33769,3640,24041,51.1,34.0,24041,40.0,28.0
18094,7436,10658,24043,56228.0,57810.0,37613.0,35625.0,70278.0,46176.0,62393,6419,66780,5372,129173,11791,24043,71.8,126.0,24043,53.5,94.0
15493,6604,8889,24045,52278.0,56508.0,39019.0,50729.0,57131.0,39439.0,41662,5754,48196,4245,89858,9999,24045,79.4,87.0,24045,59.7,65.0
5567,2436,3131,24047,56773.0,60281.0,31871.0,79135.0,58500.0,53902.0,21853,2792,24194,2068,46047,4860,24047,70.2,63.0,24047,59.8,54.0
141654,62133,79521,24510,42241.0,63126.0,33702.0,22757.0,51064.0,44509.0,249644,36380,299583,27012,549227,63392,24510,80.9,512.0,24510,61.8,388.0
16332,7347,8985,23001,47537.0,48401.0,20481.0,,73295.0,33000.0,46709,5390,50154,4136,96863,9526,23001,78.1,101.0,23001,60.8,80.0
12608,5761,6847,23003,36923.0,37289.0,24500.0,18009.0,86667.0,30167.0,29842,4255,31765,3092,61607,7347,23003,84.1,92.0,23003,62.2,68.0
32339,15055,17284,23005,60051.0,61525.0,20200.0,32167.0,50693.0,41569.0,123850,13135,135529,10366,259379,23501,23005,68.3,237.0,23005,48.9,169.0
4318,1971,2347,23007,42811.0,42892.0,,40673.0,,142344.0,13230,1633,13653,1736,26883,3369,23007,57.7,24.0,23007,48.3,20.0
7196,3075,4121,23009,47030.0,47369.0,31734.0,40464.0,63194.0,45833.0,22315,4190,24230,3497,46545,7687,23009,68.8,56.0,23009,47.1,39.0
16256,7316,8940,23011,46917.0,47161.0,,41487.0,42181.0,36250.0,51871,6022,57298,4550,109169,10572,23011,75.6,121.0,23011,57.3,91.0
4304,2232,2072,23013,50693.0,50912.0,,68611.0,34732.0,35486.0,15898,2827,17774,2158,33672,4985,23013,72.0,45.0,23013,49.2,31.0
4073,1809,2264,23015,50462.0,50394.0,,,85313.0,57414.0,14128,2238,15508,1775,29636,4013,23015,50.8,30.0,23015,43.8,26.0
9911,4357,5554,23017,40630.0,40630.0,,,31548.0,,24711,3543,25809,2981,50520,6524,23017,85.6,70.0,23017,60.9,50.0
24933,11157,13776,23019,44271.0,44456.0,30938.0,23646.0,74091.0,51875.0,65459,9179,69243,7781,134702,16960,23019,84.4,160.0,23019,60.4,116.0
3520,1643,1877,23021,37495.0,37763.0,,90417.0,,35875.0,7265,1242,7529,985,14794,2227,23021,75.8,21.0,23021,56.3,15.0
4200,1710,2490,23023,53298.0,53997.0,,,,25781.0,15131,1641,16850,1267,31981,2908,23023,66.0,31.0,23023,49.3,23.0
8907,4162,4745,23025,40066.0,39949.0,,23750.0,,37670.0,21672,3489,23389,2515,45061,6004,23025,84.3,60.0,23025,57.9,41.0
6243,2895,3348,23027,44082.0,44448.0,,19583.0,45000.0,26750.0,16656,2339,17567,2185,34223,4524,23027,83.6,44.0,23027,56.5,29.0
5946,2598,3348,23029,38083.0,38816.0,72875.0,26413.0,,50862.0,13241,2331,14250,1811,27491,4142,23029,87.8,45.0,23029,61.1,31.0
19192,7672,11520,23031,57919.0,58141.0,54063.0,27150.0,47110.0,50390.0,85969,10381,94299,7360,180268,17741,23031,71.7,187.0,23031,48.3,127.0
1575,709,866,26001,38033.0,38313.0,,59219.0,,,4712,568,4643,531,9355,1099,26001,66.2,15.0,26001,68.2,17.0
1213,635,578,26003,39300.0,38853.0,,36042.0,,,3733,590,3747,429,7480,1019,26003,48.6,8.0,26003,48.4,8.0
14185,6447,7738,26005,54264.0,54439.0,42047.0,49750.0,64063.0,41733.0,50610,5289,51742,4477,102352,9766,26005,53.7,70.0,26005,46.6,59.0
4898,2193,2705,26007,38829.0,38966.0,29375.0,26944.0,,,12241,1820,13037,1605,25278,3425,26007,77.1,35.0,26007,54.3,25.0
3316,1451,1865,26009,46845.0,47290.0,,62750.0,36042.0,40294.0,10140,1370,10359,1232,20499,2602,26009,59.1,24.0,26009,47.0,19.0
3013,1512,1501,26011,38307.0,38308.0,,,,45000.0,6758,977,6890,630,13648,1607,26011,104.9,27.0,26011,83.8,21.0
992,423,569,26013,39803.0,40481.0,,30125.0,34167.0,,2832,242,3020,293,5852,535,26013,74.9,9.0,26013,58.8,7.0
6377,2907,3470,26015,55064.0,55248.0,,27500.0,165982.0,40746.0,26953,2512,27124,2071,54077,4583,26015,45.3,34.0,26015,43.8,33.0
15804,7485,8319,26017,45583.0,46205.0,28316.0,48409.0,99444.0,33507.0,46672,5401,49948,3721,96620,9122,26017,60.7,87.0,26017,51.3,74.0
1989,936,1053,26019,47388.0,47885.0,,31000.0,,25350.0,7415,1202,7759,873,15174,2075,26019,71.4,21.0,26019,63.8,18.0
26719,11545,15174,26021,44993.0,50681.0,20854.0,52344.0,65313.0,36541.0,66019,9480,70814,8026,136833,17506,26021,69.7,143.0,26021,53.2,109.0
7310,3527,3783,26023,44373.0,44359.0,,,55208.0,24904.0,17948,2654,18762,2211,36710,4865,26023,61.6,34.0,26023,48.6,27.0
22931,10265,12666,26025,42520.0,45354.0,25172.0,47266.0,46690.0,35309.0,57482,7460,62320,5876,119802,13336,26025,71.1,119.0,26025,58.9,99.0
7576,3689,3887,26027,46570.0,48467.0,31850.0,48221.0,,31605.0,22876,3208,23121,2612,45997,5820,26027,56.1,39.0,26027,52.8,36.0
3181,1431,1750,26029,46554.0,46730.0,,40938.0,67917.0,45000.0,11309,1423,12008,1126,23317,2549,26029,61.7,24.0,26029,45.1,18.0
4595,2023,2572,26031,40219.0,40860.0,65000.0,34583.0,,25909.0,10755,1840,11273,1519,22028,3359,26031,73.6,32.0,26031,62.7,27.0
6485,3312,3173,26033,41993.0,43546.0,,39107.0,30982.0,49375.0,15235,2328,15554,1781,30789,4109,26033,73.6,34.0,26033,59.3,27.0
7895,3545,4350,26035,33015.0,33138.0,,,89107.0,25750.0,12679,2275,13375,2058,26054,4333,26035,75.6,37.0,26035,64.6,31.0
8933,4098,4835,26037,60909.0,61597.0,33585.0,,50521.0,43295.0,34356,3186,36596,2139,70952,5325,26037,36.6,31.0,26037,38.9,33.0
2073,977,1096,26039,41743.0,42022.0,,,10750.0,,6315,630,6190,578,12505,1208,26039,73.0,17.0,26039,67.1,16.0
6227,2966,3261,26041,42031.0,42837.0,,27411.0,21078.0,19375.0,15893,2084,16433,1892,32326,3976,26041,63.2,36.0,26041,47.7,27.0
3523,1489,2034,26043,43779.0,44013.0,,,,75833.0,11386,1309,12033,912,23419,2221,26043,50.7,20.0,26043,46.5,19.0
11524,5064,6460,26045,54993.0,56680.0,37141.0,59250.0,62375.0,50667.0,47705,4843,51387,3728,99092,8571,26045,51.8,68.0,26045,48.3,62.0
3506,1504,2002,26047,51018.0,51499.0,,39395.0,79375.0,30721.0,14287,1872,15012,1507,29299,3379,26047,63.0,29.0,26047,53.8,25.0
85696,38849,46847,26049,42327.0,47601.0,25521.0,38615.0,89286.0,42454.0,178891,20287,199440,14671,378331,34958,26049,80.3,399.0,26049,60.6,298.0
5211,2382,2829,26051,38021.0,38022.0,,18917.0,,43523.0,10845,1845,11109,1476,21954,3321,26051,79.0,35.0,26051,62.8,28.0
2859,1339,1520,26053,35686.0,35766.0,,31250.0,,,6260,943,6147,942,12407,1885,26053,63.1,17.0,26053,57.0,16.0
9575,4520,5055,26055,52950.0,53391.0,,49423.0,37500.0,51250.0,37680,4728,41452,3904,79132,8632,26055,66.4,74.0,26055,40.8,45.0
6792,2868,3924,26057,41912.0,42343.0,,15500.0,,30365.0,16372,1837,17609,1700,33981,3537,26057,66.0,33.0,26057,54.1,27.0
8982,4302,4680,26059,41961.0,42168.0,,35625.0,42917.0,44000.0,19711,3065,20196,2809,39907,5874,26059,62.4,39.0,26059,59.1,36.0
7406,4283,3123,26061,37776.0,39009.0,,30625.0,18139.0,36131.0,17670,2056,15133,1373,32803,3429,26061,49.6,21.0,26061,43.9,19.0
4486,2093,2393,26063,42161.0,42172.0,,14028.0,96389.0,31818.0,14149,1771,14664,1337,28813,3108,26063,56.8,31.0,26063,45.4,25.0
59468,27305,32163,26065,45679.0,49595.0,31482.0,41042.0,42423.0,35847.0,123123,13582,135036,10043,258159,23625,26065,58.8,155.0,26065,41.6,109.0
9084,4395,4689,26067,49124.0,49259.0,83275.0,73472.0,,39000.0,27175,3133,27785,2216,54960,5349,26067,63.5,43.0,26067,51.1,33.0
4395,2005,2390,26069,37317.0,37486.0,,,,42969.0,10898,1614,11358,1209,22256,2823,26069,65.6,34.0,26069,54.9,28.0
1749,875,874,26071,33663.0,33797.0,,30417.0,46875.0,32813.0,4921,649,5149,506,10070,1155,26071,60.4,15.0,26071,50.0,12.0
19390,9228,10162,26073,39377.0,39794.0,24653.0,56520.0,21724.0,33875.0,29705,4265,32384,3727,62089,7992,26073,69.2,41.0,26073,57.8,33.0
25464,11251,14213,26075,46326.0,48717.0,20446.0,40500.0,86786.0,44665.0,66927,7612,70651,6782,137578,14394,26075,82.0,157.0,26075,61.9,119.0
45473,20808,24665,26077,47476.0,51598.0,25584.0,,42484.0,38564.0,111892,12752,120882,9318,232774,22070,26077,61.3,163.0,26077,47.5,126.0
2875,1379,1496,26079,40534.0,40853.0,,25833.0,,,7510,1215,7382,1061,14892,2276,26079,73.4,18.0,26079,72.7,17.0
93489,42845,50644,26081,53063.0,56981.0,26620.0,33553.0,59680.0,36094.0,270413,33224,289867,25135,560280,58359,26081,59.3,353.0,26081,41.3,247.0
336,169,167,26083,37813.0,38320.0,,,,,1022,115,956,97,1978,212,26083,,2.0,26083,,
3164,1509,1655,26085,30439.0,32391.0,13616.0,,,,4793,755,4941,570,9734,1325,26085,77.4,16.0,26085,66.8,14.0
9152,4261,4891,26087,52996.0,53023.0,8947.0,,,38975.0,38764,4435,39708,3818,78472,8253,26087,71.9,76.0,26087,56.6,58.0
2245,1099,1146,26089,56189.0,57190.0,,28583.0,,44412.0,9505,1155,10196,775,19701,1930,26089,35.7,14.0,26089,31.5,13.0
13427,6044,7383,26091,48043.0,48743.0,32452.0,,38750.0,31194.0,42704,4735,44449,3837,87153,8572,26091,60.0,73.0,26091,48.8,60.0
10895,4813,6082,26093,75204.0,75159.0,59350.0,72885.0,100139.0,79917.0,85073,6726,86466,5495,171539,12221,26093,54.6,108.0,26093,44.2,86.0
1059,453,606,26095,37088.0,38668.0,,35089.0,,27857.0,2435,347,2435,217,4870,564,26095,84.0,8.0,26095,56.7,6.0
1730,818,912,26097,38434.0,40656.0,,31429.0,33214.0,44286.0,4638,839,4680,745,9318,1584,26097,61.9,12.0,26097,46.6,9.0
106546,46437,60109,26099,54582.0,56997.0,34265.0,38107.0,66980.0,48125.0,368100,43732,401222,35114,769322,78846,26099,75.2,756.0,26099,52.2,527.0
3918,1767,2151,26101,41395.0,41518.0,,38548.0,41477.0,42917.0,9995,1585,10661,1055,20656,2640,26101,67.3,27.0,26101,51.4,21.0
10689,4951,5738,26103,45409.0,45724.0,,22188.0,54509.0,15750.0,28379,4020,30126,2915,58505,6935,26103,64.9,54.0,26103,50.5,42.0
4861,2242,2619,26105,42024.0,42543.0,31625.0,30833.0,,31650.0,12285,1895,12820,1407,25105,3302,26105,54.9,24.0,26105,56.9,25.0
9338,4257,5081,26107,41889.0,42455.0,,53917.0,,23162.0,18956,2724,19265,2128,38221,4852,26107,69.4,36.0,26107,52.3,27.0
3774,1517,2257,26109,40373.0,40683.0,,28854.0,88571.0,,10669,1146,10471,1131,21140,2277,26109,50.1,19.0,26109,49.3,19.0
10955,4988,5967,26111,54059.0,53806.0,35774.0,40640.0,104031.0,44655.0,37251,3602,39026,3132,76277,6734,26111,58.0,60.0,26111,40.3,42.0
2490,1153,1337,26113,41098.0,41140.0,47083.0,35833.0,76827.0,48542.0,6595,1016,6522,738,13117,1754,26113,73.3,15.0,26113,54.3,11.0
16860,7388,9472,26115,55653.0,56047.0,38200.0,34792.0,75833.0,41131.0,67649,6066,70833,5009,138482,11075,26115,63.6,115.0,26115,57.0,101.0
10924,4760,6164,26117,41584.0,41740.0,29750.0,11786.0,115756.0,30250.0,26455,3758,27230,3094,53685,6852,26117,75.3,56.0,26117,59.2,44.0
1568,611,957,26119,36250.0,36132.0,,,,38750.0,4024,700,4066,499,8090,1199,26119,78.6,15.0,26119,56.1,11.0
31550,14092,17458,26121,42829.0,46702.0,21751.0,44643.0,,33954.0,72693,8208,79276,6412,151969,14620,26121,77.6,155.0,26121,58.4,118.0
8605,3978,4627,26123,43693.0,44129.0,31705.0,50329.0,31250.0,34009.0,21189,2645,21487,2188,42676,4833,26123,63.8,40.0,26123,60.7,38.0
123086,54727,68359,26125,67465.0,70729.0,46821.0,42222.0,101426.0,49646.0,540991,53142,583675,45780,1124666,98922,26125,62.8,866.0,26125,41.0,567.0
5285,2524,2761,26127,41617.0,41925.0,,40938.0,,32094.0,11339,1861,11398,1458,22737,3319,26127,51.2,19.0,26127,46.3,17.0
4537,2019,2518,26129,36063.0,35885.0,36250.0,57639.0,160729.0,38077.0,9179,1263,9466,1044,18645,2307,26129,73.2,27.0,26129,58.9,22.0
967,464,503,26131,34459.0,34587.0,,25000.0,,51875.0,2755,457,2664,358,5419,815,26131,71.1,10.0,26131,55.4,8.0
5032,2248,2784,26133,38999.0,39103.0,21406.0,33125.0,,30833.0,9666,1847,10119,1340,19785,3187,26133,97.0,31.0,26133,64.2,21.0
1656,770,886,26135,33021.0,33417.0,,14375.0,,37143.0,3544,791,3402,664,6946,1455,26135,87.3,14.0,26135,66.0,10.0
3270,1318,1952,26137,48917.0,49180.0,,,,51133.0,10454,1369,11063,1070,21517,2439,26137,68.2,23.0,26137,61.2,21.0
27361,12381,14980,26139,58989.0,60547.0,27889.0,33942.0,54567.0,45592.0,124049,9990,129902,7876,253951,17866,26139,39.3,105.0,26139,32.1,86.0
1761,792,969,26141,41213.0,41351.0,,,90833.0,36563.0,5692,745,5811,629,11503,1374,26141,57.9,15.0,26141,60.2,16.0
4885,2222,2663,26143,35133.0,35201.0,,38042.0,,26771.0,10354,1533,10736,1218,21090,2751,26143,81.0,41.0,26143,60.1,30.0
34825,15792,19033,26145,43042.0,48007.0,24158.0,46719.0,63417.0,36160.0,83873,8958,92158,8175,176031,17133,26145,69.1,173.0,26145,50.5,127.0
23128,10571,12557,26147,49730.0,50565.0,22699.0,50625.0,54013.0,46766.0,70567,8439,73895,6338,144462,14777,26147,69.5,141.0,26147,59.5,122.0
10319,4684,5635,26149,44449.0,45116.0,24271.0,38929.0,,31086.0,26216,3753,27574,2924,53790,6677,26149,65.7,49.0,26149,53.0,40.0
6522,2816,3706,26151,41100.0,41219.0,76250.0,20227.0,,40125.0,17714,2968,18524,2512,36238,5480,26151,50.2,30.0,26151,47.6,29.0
1735,831,904,26153,34118.0,34833.0,,31125.0,29306.0,,3498,543,3717,421,7215,964,26153,70.8,10.0,26153,62.0,9.0
9790,4325,5465,26155,48233.0,48337.0,,27750.0,,36667.0,29932,3966,31666,3101,61598,7067,26155,77.9,67.0,26155,59.0,51.0
8317,3963,4354,26157,43768.0,43816.0,24688.0,50000.0,90556.0,38750.0,23607,3046,24523,2326,48130,5372,26157,73.5,55.0,26157,52.8,39.0
14029,6400,7629,26159,46008.0,48232.0,19101.0,29375.0,,36218.0,32007,5068,34044,3772,66051,8840,26159,68.2,63.0,26159,58.9,53.0
51965,25329,26636,26161,61003.0,66530.0,35301.0,58083.0,61688.0,43274.0,160510,11975,167436,9812,327946,21787,26161,54.4,172.0,26161,39.3,123.0
440449,200486,239963,26163,41210.0,54162.0,26888.0,32859.0,74541.0,37103.0,726438,121939,823153,95246,1549591,217185,26163,83.0,1634.0,26163,57.7,1136.0
5631,2846,2785,26165,41534.0,41456.0,16050.0,46250.0,100625.0,,14036,2235,14703,1532,28739,3767,26165,90.7,38.0,26165,66.9,28.0
1937,960,977,27001,42252.0,42640.0,,32500.0,67188.0,55446.0,7304,628,7277,437,14581,1065,27001,,,27001,40.3,13.0
25925,12012,13913,27003,70873.0,73086.0,43586.0,51309.0,71750.0,45635.0,155823,11886,159251,9448,315074,21334,27003,,,27003,48.4,145.0
4160,1754,2406,27005,52038.0,53711.0,,30650.0,42500.0,42679.0,14446,1952,14841,1504,29287,3456,27005,,,27005,46.1,21.0
8118,3825,4293,27007,44757.0,48882.0,,30591.0,82546.0,17813.0,19419,3079,19771,2658,39190,5737,27007,,,27007,41.3,20.0
5732,2314,3418,27009,52178.0,53595.0,,21645.0,,53000.0,17465,1820,18070,1356,35535,3176,27009,,,27009,38.8,15.0
719,260,459,27011,47794.0,48235.0,,,,40625.0,2288,174,2417,126,4705,300,27011,,,27011,55.9,6.0
11745,5827,5918,27013,50061.0,51956.0,25134.0,,39279.0,42656.0,30414,2115,30581,1479,60995,3594,27013,,,27013,39.6,25.0
1887,931,956,27015,52598.0,53084.0,,42813.0,,32404.0,11642,841,11987,579,23629,1420,27015,,,27015,41.6,16.0
4727,2502,2225,27017,53227.0,54957.0,,34417.0,21402.0,46833.0,16346,1305,15943,971,32289,2276,27017,,,27017,48.7,22.0
4172,1886,2286,27019,86323.0,86668.0,50938.0,62868.0,117361.0,70083.0,44942,2338,46391,1785,91333,4123,27019,,,27019,38.8,28.0
4656,2195,2461,27021,46531.0,48993.0,48688.0,28500.0,21667.0,45292.0,12836,1582,12842,1039,25678,2621,27021,,,27021,50.8,24.0
1454,571,883,27023,50858.0,51214.0,,78800.0,,26016.0,5383,518,5591,468,10974,986,27023,,,27023,29.6,6.0
2889,1389,1500,27025,71001.0,71096.0,57083.0,78438.0,76806.0,51858.0,24809,1884,24450,1341,49259,3225,27025,,,27025,44.9,24.0
7202,3333,3869,27027,57965.0,60174.0,8333.0,,,39500.0,27578,2300,29120,1387,56698,3687,27027,,,27027,42.7,25.0
1451,704,747,27029,43421.0,44715.0,,26250.0,83750.0,,3809,573,3785,488,7594,1061,27029,,,27029,48.3,6.0
588,242,346,27031,52299.0,55572.0,,32679.0,,,2296,290,2368,196,4664,486,27031,,,27031,,
1905,862,1043,27033,46750.0,49093.0,,,30833.0,,5179,423,5585,249,10764,672,27033,,,27033,38.4,7.0
7028,3396,3632,27035,49435.0,49534.0,57857.0,53929.0,,,28271,2773,29546,1754,57817,4527,27035,,,27035,50.8,47.0
31270,13735,17535,27037,75567.0,78766.0,47428.0,38646.0,77558.0,42576.0,186300,13285,195459,11601,381759,24886,27037,,,27037,40.8,148.0
1342,575,767,27039,68116.0,68404.0,,88750.0,,54211.0,9491,582,9571,500,19062,1082,27039,,,27039,40.0,8.0
3438,1671,1767,27041,54531.0,54764.0,,45625.0,,,16951,1242,17145,892,34096,2134,27041,,,27041,38.1,21.0
1878,814,1064,27043,47540.0,47579.0,,,,36518.0,6459,557,6437,466,12896,1023,27043,,,27043,43.1,10.0
2280,1062,1218,27045,51665.0,51930.0,21500.0,63125.0,35972.0,26250.0,9245,1033,9430,806,18675,1839,27045,,,27045,30.0,10.0
3679,1371,2308,27047,47105.0,47795.0,18646.0,,46750.0,31250.0,13709,1357,14389,970,28098,2327,27047,,,27047,39.2,19.0
5104,2254,2850,27049,57062.0,57590.0,21136.0,,,40497.0,20893,1771,21272,1646,42165,3417,27049,,,27049,41.2,26.0
533,209,324,27051,50174.0,49856.0,,,,70625.0,2788,185,2794,134,5582,319,27051,,,27051,41.4,4.0
146382,68632,77750,27053,65834.0,72970.0,28231.0,29306.0,73912.0,42572.0,531559,53042,563962,39808,1095521,92850,27053,,,27053,35.7,411.0
2031,1013,1018,27055,53809.0,54051.0,,46797.0,,41563.0,8778,546,8804,468,17582,1014,27055,,,27055,30.6,9.0
2368,1092,1276,27057,47486.0,48053.0,,29773.0,87083.0,45804.0,9250,975,9560,698,18810,1673,27057,,,27057,46.1,16.0
2802,1404,1398,27059,59865.0,60490.0,,2499.0,132917.0,68889.0,17605,1560,17777,1036,35382,2596,27059,,,27059,45.0,18.0
6018,2849,3169,27061,47761.0,48083.0,,36667.0,,31438.0,20410,2134,20142,1898,40552,4032,27061,,,27061,47.2,32.0
1085,524,561,27063,50574.0,51333.0,,,35156.0,35938.0,4773,334,4757,226,9530,560,27063,,,27063,27.0,5.0
2242,1011,1231,27065,47384.0,47796.0,,34583.0,,34219.0,7273,765,7292,542,14565,1307,27065,,,27065,36.9,8.0
4877,2120,2757,27067,52632.0,54425.0,15345.0,53403.0,32381.0,37352.0,19068,1997,19480,1287,38548,3284,27067,,,27067,40.2,22.0
474,179,295,27069,52326.0,52409.0,,,,55417.0,2048,173,2015,123,4063,296,27069,,,27069,,
1937,956,981,27071,42919.0,43818.0,,26433.0,,,5810,670,5986,427,11796,1097,27071,,,27071,47.0,10.0
561,250,311,27073,49903.0,50202.0,,,,23333.0,3298,203,3252,145,6550,348,27073,,,27073,37.9,5.0
1364,687,677,27075,48417.0,49098.0,,68750.0,,,5051,326,4860,344,9911,670,27075,,,27075,43.7,8.0
363,162,201,27077,42263.0,42038.0,,,,,1792,222,1769,112,3561,334,27077,,,27077,45.6,3.0
2482,1203,1279,27079,60632.0,60939.0,,25833.0,56875.0,43859.0,13150,806,12839,735,25989,1541,27079,,,27079,38.0,13.0
524,207,317,27081,49575.0,49750.0,,50139.0,,28281.0,2669,198,2607,169,5276,367,27081,,,27081,36.2,4.0
3456,1351,2105,27083,51600.0,52252.0,42984.0,2499.0,50958.0,36735.0,11652,1034,12152,562,23804,1596,27083,,,27083,37.5,11.0
2866,1279,1587,27085,56128.0,56525.0,,,,47143.0,16345,1426,16902,1057,33247,2483,27085,,,27085,40.4,18.0
1350,638,712,27087,41118.0,49009.0,,28750.0,,27500.0,2291,464,2243,460,4534,924,27087,,,27087,82.7,6.0
734,286,448,27089,54092.0,54182.0,,43750.0,,47875.0,4370,405,4280,330,8650,735,27089,,,27089,53.6,8.0
2286,870,1416,27091,51391.0,51136.0,,,91071.0,,9251,725,9456,690,18707,1415,27091,,,27091,31.1,11.0
2282,951,1331,27093,55042.0,55314.0,26154.0,,,28750.0,10443,1102,10532,754,20975,1856,27093,,,27093,40.7,13.0
3080,1382,1698,27095,49094.0,49830.0,21750.0,35192.0,61250.0,,11568,1188,11699,896,23267,2084,27095,,,27095,56.2,19.0
3687,1602,2085,27097,50049.0,50062.0,12096.0,,60481.0,62946.0,15039,1432,15147,1013,30186,2445,27097,,,27097,39.6,17.0
5410,2667,2743,27099,49427.0,50400.0,34784.0,8466.0,61250.0,37673.0,17518,1895,18117,1318,35635,3213,27099,,,27099,38.5,22.0
771,335,436,27101,51983.0,52296.0,,,,24464.0,3890,299,3905,322,7795,621,27101,,,27101,33.5,5.0
3814,1884,1930,27103,58640.0,59802.0,12708.0,,65972.0,54219.0,15555,844,15863,644,31418,1488,27103,,,27103,35.5,12.0
3320,1569,1751,27105,50625.0,52012.0,40152.0,21250.0,,49118.0,9434,1648,9187,1130,18621,2778,27105,,,27105,26.6,8.0
846,383,463,27107,50377.0,50709.0,,,60417.0,32125.0,2979,343,3049,195,6028,538,27107,,,27107,38.6,5.0
13237,5835,7402,27109,68023.0,69078.0,31314.0,66910.0,82372.0,48525.0,66247,5093,71931,3469,138178,8562,27109,,,27109,32.3,50.0
5635,2449,3186,27111,52365.0,53219.0,15750.0,45820.0,,52841.0,26409,1967,26916,1504,53325,3471,27111,,,27111,42.0,39.0
1286,567,719,27113,47127.0,47149.0,,52917.0,115655.0,,6487,499,6681,240,13168,739,27113,,,27113,34.0,6.0
4015,1890,2125,27115,44549.0,45123.0,,26932.0,49286.0,31719.0,12590,1473,12495,1049,25085,2522,27115,,,27115,45.4,18.0
1182,449,733,27117,46990.0,47188.0,,27386.0,,45076.0,3966,479,4408,339,8374,818,27117,,,27117,46.9,6.0
3987,1987,2000,27119,53326.0,54126.0,,29464.0,89286.0,34833.0,14463,1226,14393,900,28856,2126,27119,,,27119,44.2,18.0
1011,431,580,27121,52785.0,52799.0,,31667.0,,,5121,385,5047,219,10168,604,27121,,,27121,39.3,7.0
84589,38727,45862,27123,56104.0,62782.0,27800.0,36458.0,47054.0,37542.0,228045,26230,249216,19701,477261,45931,27123,,,27123,43.0,227.0
431,206,225,27125,50332.0,50918.0,,22917.0,,31250.0,1872,184,1914,68,3786,252,27125,,,27125,54.2,3.0
1825,900,925,27127,47211.0,47872.0,,41667.0,25000.0,23750.0,7054,757,7071,571,14125,1328,27127,,,27127,43.7,11.0
1646,676,970,27129,52149.0,53252.0,2499.0,51667.0,,40313.0,7016,563,6798,503,13814,1066,27129,,,27129,35.4,8.0
6469,2720,3749,27131,59598.0,61199.0,23599.0,,55729.0,34931.0,27682,2731,29574,2022,57256,4753,27131,,,27131,45.0,30.0
1067,431,636,27133,51496.0,51725.0,,38750.0,,,4210,337,4483,312,8693,649,27133,,,27133,30.3,5.0
1637,749,888,27135,53199.0,53498.0,,55144.0,42000.0,15357.0,7498,407,7133,385,14631,792,27135,,,27135,47.7,9.0
30869,14248,16621,27137,48331.0,49984.0,15306.0,24400.0,29063.0,49688.0,91466,7407,93151,5140,184617,12547,27137,,,27137,47.0,126.0
7747,3527,4220,27139,87794.0,88977.0,85438.0,59079.0,84250.0,54960.0,63816,4279,64480,3368,128296,7647,27139,,,27139,43.8,41.0
6966,2952,4014,27141,74170.0,74745.0,27833.0,,63986.0,62971.0,41926,2684,42301,1600,84227,4284,27141,,,27141,43.2,30.0
1584,699,885,27143,56990.0,57450.0,,,,42031.0,7125,445,6891,431,14016,876,27143,,,27143,45.6,9.0
19570,9275,10295,27145,56336.0,57938.0,26019.0,41071.0,42215.0,31556.0,70278,5627,71882,3644,142160,9271,27145,,,27145,35.2,55.0
3721,1400,2321,27147,57858.0,59627.0,30000.0,,50795.0,47097.0,16659,1065,17658,754,34317,1819,27147,,,27147,33.3,15.0
1727,895,832,27149,52302.0,52488.0,,23636.0,,,4668,219,4615,184,9283,403,27149,,,27149,,
1167,397,770,27151,49035.0,50305.0,,,,45556.0,4446,326,4412,204,8858,530,27151,,,27151,56.1,8.0
3548,1677,1871,27153,46414.0,46225.0,,,,40547.0,10868,1518,10527,1372,21395,2890,27153,,,27153,38.0,13.0
341,139,202,27155,49186.0,50029.0,,,,,1586,79,1623,53,3209,132,27155,,,27155,,
1547,742,805,27157,56510.0,56914.0,,,53750.0,37228.0,10047,612,10101,434,20148,1046,27157,,,27157,48.6,14.0
2211,979,1232,27159,41906.0,42500.0,101094.0,,,36500.0,6044,661,6338,424,12382,1085,27159,,,27159,43.8,10.0
1544,752,792,27161,53564.0,55830.0,21652.0,,22885.0,,8524,560,8332,512,16856,1072,27161,,,27161,48.1,11.0
13109,5830,7279,27163,83706.0,84106.0,71989.0,72031.0,102145.0,50737.0,112949,6485,119396,4682,232345,11167,27163,,,27163,40.2,91.0
1182,351,831,27165,50604.0,50693.0,,,,47500.0,4631,777,4882,629,9513,1406,27165,,,27165,46.5,8.0
627,219,408,27167,51476.0,51867.0,,58092.0,,54000.0,3036,206,2959,173,5995,379,27167,,,27167,,
6933,3476,3457,27169,50547.0,50999.0,11108.0,36150.0,101625.0,58241.0,22371,2613,24235,1509,46606,4122,27169,,,27169,37.8,22.0
7846,3355,4491,27171,73557.0,73754.0,47813.0,30179.0,73625.0,57705.0,60440,3886,60402,3171,120842,7057,27171,,,27171,42.5,44.0
1175,588,587,27173,53041.0,53519.0,,42917.0,,41000.0,4645,462,4459,344,9104,806,27173,,,27173,42.7,6.0
6105,2917,3188,29001,37516.0,39643.0,16696.0,8496.0,2499.0,13228.0,10824,1177,11811,1435,22635,2612,29001,57.8,15.0,29001,43.1,12.0
1531,828,703,29003,55613.0,55932.0,41055.0,64178.0,,40391.0,7657,827,8051,579,15708,1406,29003,50.5,11.0,29003,37.9,9.0
693,298,395,29005,43933.0,44573.0,,,20962.0,93750.0,2268,394,2392,287,4660,681,29005,71.0,7.0,29005,58.1,6.0
4401,2030,2371,29007,41310.0,42541.0,23938.0,,,32353.0,9791,1853,10925,1539,20716,3392,29007,90.1,29.0,29007,63.3,21.0
7072,3303,3769,29009,39033.0,39075.0,,48750.0,35938.0,37436.0,14276,3505,14770,2880,29046,6385,29009,77.4,39.0,29009,60.1,31.0
2910,1329,1581,29011,37467.0,37980.0,,38125.0,,30326.0,5177,780,5425,668,10602,1448,29011,67.2,12.0,29011,49.1,9.0
2996,1355,1641,29013,41060.0,41683.0,35913.0,,,43261.0,6891,1119,7239,1100,14130,2219,29013,80.8,19.0,29013,62.0,15.0
3540,1492,2048,29015,33042.0,33328.0,,27857.0,,28802.0,8015,1303,8169,1163,16184,2466,29015,89.1,33.0,29015,66.7,24.0
2654,1198,1456,29017,39707.0,40323.0,,,25750.0,,5313,833,5358,766,10671,1599,29017,96.4,16.0,29017,72.5,12.0
31824,14224,17600,29019,49899.0,52249.0,28734.0,31098.0,34406.0,41598.0,74337,7488,81131,6446,155468,13934,29019,63.4,86.0,29019,47.2,63.0
15456,7270,8186,29021,46315.0,47342.0,31925.0,,55583.0,37043.0,35906,6568,38780,5467,74686,12035,29021,86.8,88.0,29021,65.1,67.0
8942,3780,5162,29023,35738.0,36734.0,25762.0,49286.0,,31042.0,17314,3107,19400,2516,36714,5623,29023,95.7,56.0,29023,78.3,46.0
1186,487,699,29025,43691.0,42852.0,,,,63482.0,3960,481,4001,453,7961,934,29025,89.3,11.0,29025,75.2,10.0
5865,2577,3288,29027,47744.0,48881.0,23140.0,64464.0,61603.0,,18353,2151,19311,2318,37664,4469,29027,79.4,39.0,29027,54.3,26.0
7516,3496,4020,29029,44816.0,45256.0,,,,16121.0,17731,3647,18484,3655,36215,7302,29029,68.6,51.0,29029,47.4,35.0
13626,6203,7423,29031,46050.0,48762.0,18837.0,45583.0,,28361.0,33392,3674,35954,3535,69346,7209,29031,70.1,62.0,29031,56.6,50.0
1273,555,718,29033,42415.0,43854.0,,,,,3922,437,4094,549,8016,986,29033,94.6,13.0,29033,63.4,9.0
1319,613,706,29035,33034.0,33765.0,,2499.0,,40536.0,2380,608,2712,551,5092,1159,29035,110.0,9.0,29035,92.3,8.0
9805,3862,5943,29037,61584.0,61169.0,64260.0,61750.0,91161.0,52148.0,43701,5306,46476,4398,90177,9704,29037,70.1,81.0,29037,53.8,63.0
3381,1827,1554,29039,31532.0,31765.0,,,,,5604,1255,5514,1376,11118,2631,29039,78.3,17.0,29039,56.7,13.0
1213,572,641,29041,40642.0,41181.0,23833.0,35000.0,,33750.0,3427,307,3430,269,6857,576,29041,67.7,8.0,29041,50.0,6.0
8879,3800,5079,29043,53270.0,53252.0,36563.0,77308.0,,40920.0,33745,5297,36471,4930,70216,10227,29043,63.0,53.0,29043,45.9,37.0
928,459,469,29045,43883.0,44467.0,,37321.0,,,2926,543,2883,497,5809,1040,29045,95.2,9.0,29045,67.8,7.0
20137,9091,11046,29047,62099.0,63678.0,41523.0,65202.0,67212.0,54515.0,99877,12035,105832,11096,205709,23131,29047,79.0,173.0,29047,55.7,122.0
1856,763,1093,29049,54773.0,55192.0,34450.0,36157.0,72386.0,45806.0,8726,1260,8835,1212,17561,2472,29049,83.5,22.0,29049,59.3,15.0
9237,4466,4771,29051,53088.0,56494.0,28977.0,31417.0,60521.0,37941.0,31386,3738,34245,3179,65631,6917,29051,64.0,53.0,29051,45.3,37.0
2354,1129,1225,29053,44549.0,46331.0,16568.0,,104107.0,51250.0,6966,1006,7347,725,14313,1731,29053,69.0,15.0,29053,51.3,11.0
5093,2385,2708,29055,36743.0,36935.0,,,,25536.0,9853,2166,10515,1841,20368,4007,29055,93.1,30.0,29055,75.0,24.0
1473,738,735,29057,37035.0,37407.0,,,,24792.0,3152,649,3070,613,6222,1262,29057,83.3,10.0,29057,58.4,7.0
3577,1685,1892,29059,38062.0,38663.0,,,,54015.0,6336,1862,6412,1760,12748,3622,29059,79.2,18.0,29059,55.9,13.0
1340,567,773,29061,41642.0,41627.0,,,,39375.0,3130,916,3150,881,6280,1797,29061,75.0,9.0,29061,58.9,7.0
1391,636,755,29063,41406.0,41309.0,,,,13946.0,4219,527,4212,393,8431,920,29063,39.5,6.0,29063,38.4,6.0
3642,1575,2067,29065,36831.0,37297.0,,,,24500.0,6000,1568,6542,1327,12542,2895,29065,74.4,17.0,29065,62.9,14.0
2941,1441,1500,29067,30508.0,30627.0,,,,,5437,1236,5560,1160,10997,2396,29067,51.9,11.0,29067,46.7,10.0
8536,3850,4686,29069,31077.0,32203.0,22269.0,,,34145.0,12334,2629,13394,2534,25728,5163,29069,100.1,41.0,29069,81.2,33.0
11941,5839,6102,29071,48480.0,48655.0,,87837.0,78819.0,,44984,5261,45939,4878,90923,10139,29071,76.9,92.0,29071,54.4,64.0
2316,1157,1159,29073,42826.0,43062.0,,,,,6544,770,6742,619,13286,1389,29073,64.0,15.0,29073,38.0,9.0
1119,497,622,29075,41912.0,42132.0,,,,,2818,397,3044,362,5862,759,29075,66.3,7.0,29075,54.1,6.0
51533,22824,28709,29077,41227.0,42115.0,29896.0,45140.0,28311.0,33079.0,114052,21695,125498,18123,239550,39818,29077,69.8,220.0,29077,51.3,162.0
2020,900,1120,29079,37656.0,37941.0,,81563.0,,,4033,812,4472,755,8505,1567,29079,71.9,11.0,29079,55.6,9.0
1485,676,809,29081,39301.0,39569.0,,,,40556.0,3585,681,3697,573,7282,1254,29081,79.6,11.0,29081,55.6,8.0
4131,1852,2279,29083,42181.0,42236.0,68833.0,70020.0,,,9081,1570,9737,1406,18818,2976,29083,100.3,33.0,29083,83.6,28.0
2394,992,1402,29085,32122.0,32780.0,,20208.0,,,3643,917,3872,822,7515,1739,29085,73.4,16.0,29085,62.0,13.0
555,269,286,29087,42500.0,43222.0,,,,48750.0,1970,278,1969,281,3939,559,29087,68.3,5.0,29087,43.1,3.0
1587,768,819,29089,44820.0,46544.0,41250.0,21429.0,,,4509,504,4607,435,9116,939,29089,54.6,7.0,29089,39.9,5.0
9158,4270,4888,29091,32784.0,32650.0,,15455.0,,,16754,2599,18027,2511,34781,5110,29091,81.4,44.0,29091,65.0,36.0
2293,1090,1203,29093,36239.0,36659.0,22917.0,20938.0,,105625.0,4038,863,4303,775,8341,1638,29093,103.3,16.0,29093,58.5,9.0
119678,53111,66567,29095,46869.0,54974.0,31492.0,30028.0,49490.0,34168.0,274189,51746,301575,46734,575764,98480,29095,75.3,542.0,29095,55.3,398.0
19556,8607,10949,29097,41811.0,42224.0,25515.0,35250.0,,35396.0,47538,9084,50298,9147,97836,18231,29097,85.8,109.0,29097,60.7,78.0
23937,11024,12913,29099,55348.0,55751.0,38389.0,38500.0,83750.0,52917.0,97569,11891,100070,10451,197639,22342,29099,85.9,195.0,29099,71.6,157.0
8407,4131,4276,29101,49792.0,50856.0,40158.0,31541.0,47989.0,41678.0,22043,2750,23188,2558,45231,5308,29101,66.1,33.0,29101,54.1,26.0
823,384,439,29103,38289.0,38365.0,,,,39792.0,1561,424,1540,433,3101,857,29103,92.7,6.0,29103,81.5,5.0
6816,3199,3617,29105,39712.0,40029.0,,61118.0,2499.0,44762.0,14481,2881,14812,2946,29293,5827,29105,76.5,35.0,29105,60.9,27.0
3706,1584,2122,29107,50723.0,51152.0,38971.0,,,33125.0,14263,1786,14908,1447,29171,3233,29107,73.9,32.0,29107,50.1,21.0
7052,3252,3800,29109,40597.0,40735.0,,45938.0,74519.0,35231.0,15755,2885,16235,2782,31990,5667,29109,66.5,34.0,29109,53.7,27.0
1215,532,683,29111,43909.0,43913.0,39500.0,,,51793.0,4568,481,4372,548,8940,1029,29111,79.9,11.0,29111,68.9,9.0
7980,3595,4385,29113,53718.0,54425.0,42428.0,,16453.0,,23642,2898,23748,3079,47390,5977,29113,87.7,45.0,29113,67.8,35.0
2196,1008,1188,29115,37997.0,38542.0,32500.0,,,20227.0,5065,811,5529,919,10594,1730,29115,91.5,17.0,29115,65.6,12.0
2273,954,1319,29117,43350.0,43799.0,,87969.0,,25430.0,5604,965,6401,794,12005,1759,29117,86.8,18.0,29117,70.4,15.0
4876,2218,2658,29119,38368.0,39301.0,16350.0,26875.0,29839.0,32448.0,8953,2573,8596,2482,17549,5055,29119,77.8,19.0,29119,80.6,19.0
2895,1311,1584,29121,36976.0,37386.0,17466.0,,88500.0,16081.0,6564,896,6670,1058,13234,1954,29121,41.9,10.0,29121,40.9,10.0
2238,888,1350,29123,35097.0,34890.0,,,,,4999,953,5528,752,10527,1705,29123,106.8,19.0,29123,98.5,17.0
1721,883,838,29125,39700.0,40221.0,,74844.0,,,3874,585,3844,630,7718,1215,29125,60.4,8.0,29125,72.6,9.0
5020,2181,2839,29127,40814.0,41656.0,31304.0,,71500.0,,11569,1990,12609,1996,24178,3986,29127,87.9,33.0,29127,58.6,22.0
584,269,315,29129,40768.0,41031.0,,,,,1438,395,1507,322,2945,717,29129,114.1,7.0,29129,74.2,4.0
4942,2218,2724,29131,38094.0,39131.0,,23113.0,,16721.0,10355,1786,10929,1608,21284,3394,29131,88.8,28.0,29131,68.4,22.0
3642,1370,2272,29133,28347.0,34033.0,20508.0,,,,4754,1288,5250,1214,10004,2502,29133,100.0,18.0,29133,97.2,17.0
1885,896,989,29135,47725.0,47576.0,,,,66250.0,5859,1191,6205,1222,12064,2413,29135,54.6,10.0,29135,46.6,8.0
1260,621,639,29137,43138.0,43250.0,,44375.0,53750.0,,3677,648,3682,566,7359,1214,29137,77.2,10.0,29137,44.1,6.0
2025,923,1102,29139,39830.0,40322.0,26719.0,,,16667.0,4996,786,5140,676,10136,1462,29139,83.0,14.0,29139,50.7,9.0
4757,2515,2242,29141,33525.0,34045.0,,,,62634.0,7732,2303,7555,2318,15287,4621,29141,85.0,29.0,29141,65.6,23.0
4094,1799,2295,29143,33630.0,37295.0,21612.0,,,43333.0,7092,1596,7626,1728,14718,3324,29143,112.7,28.0,29143,84.5,21.0
8377,3814,4563,29145,43290.0,43572.0,42438.0,32173.0,46627.0,22381.0,24386,4432,24757,4545,49143,8977,29145,57.8,42.0,29145,55.5,40.0
5682,2463,3219,29147,35854.0,36329.0,,,21667.0,,9723,1143,10229,1189,19952,2332,29147,73.5,18.0,29147,48.7,12.0
2824,1355,1469,29149,29851.0,30494.0,,12500.0,,,4449,885,4581,930,9030,1815,29149,65.2,12.0,29149,40.7,7.0
1139,603,536,29151,52693.0,52886.0,,,,,6519,641,6123,336,12642,977,29151,59.6,10.0,29151,41.5,7.0
2292,1023,1269,29153,31399.0,31765.0,,,,8944.0,3965,858,3938,719,7903,1577,29153,78.9,14.0,29153,61.6,11.0
5068,2070,2998,29155,29238.0,35411.0,15571.0,,,49023.0,6879,1462,7736,1580,14615,3042,29155,88.6,19.0,29155,90.5,19.0
1798,765,1033,29157,51499.0,51614.0,,,,33594.0,8633,751,8765,658,17398,1409,29157,75.1,18.0,29157,53.2,13.0
7484,3292,4192,29159,39928.0,40686.0,40724.0,20938.0,,29663.0,16923,3233,18256,3036,35179,6269,29159,71.2,35.0,29159,55.3,27.0
8137,4289,3848,29161,41618.0,42626.0,11517.0,58030.0,41504.0,30286.0,20113,2833,18995,2189,39108,5022,29161,71.7,36.0,29161,51.7,26.0
2482,1017,1465,29163,41750.0,42899.0,32550.0,41563.0,,26250.0,6882,1238,7243,908,14125,2146,29163,94.3,22.0,29163,57.0,13.0
7106,2824,4282,29165,68254.0,70496.0,45786.0,76375.0,59122.0,61890.0,41729,3706,43224,3804,84953,7510,29165,59.8,56.0,29165,44.2,40.0
5515,2420,3095,29167,41130.0,41725.0,2499.0,21187.0,,48636.0,13045,1922,13745,1993,26790,3915,29167,66.0,26.0,29167,54.0,21.0
5781,2598,3183,29169,47931.0,48184.0,48920.0,,78450.0,45300.0,16880,2934,17970,2288,34850,5222,29169,103.4,35.0,29169,67.9,23.0
926,444,482,29171,36346.0,36212.0,,,,,2057,382,2040,363,4097,745,29171,92.9,7.0,29171,63.3,5.0
1254,511,743,29173,47345.0,47413.0,41875.0,,,,4421,700,4473,595,8894,1295,29173,67.0,9.0,29173,65.7,9.0
4395,1944,2451,29175,37832.0,39595.0,15709.0,,,,9737,1641,10388,1432,20125,3073,29175,84.8,25.0,29175,62.8,18.0
3598,1755,1843,29177,52526.0,52587.0,,108200.0,250001.0,50625.0,10234,1135,10395,986,20629,2121,29177,92.8,27.0,29177,77.3,22.0
1361,658,703,29179,35648.0,36265.0,,15938.0,,,2900,383,2725,436,5625,819,29179,68.4,7.0,29179,59.6,6.0
3167,1376,1791,29181,32444.0,33000.0,,,,,5641,1250,5926,1100,11567,2350,29181,95.0,20.0,29181,82.0,17.0
23022,10046,12976,29183,72415.0,72967.0,55829.0,63958.0,86996.0,66224.0,170019,13371,177309,12345,347328,25716,29183,73.7,264.0,29183,50.0,176.0
2156,1042,1114,29185,32046.0,32110.0,,23750.0,,54318.0,3806,881,3809,792,7615,1673,29185,73.6,13.0,29185,66.6,12.0
2540,925,1615,29186,47014.0,46981.0,16767.0,,,25313.0,8552,418,8046,767,16598,1185,29186,53.6,13.0,29186,62.5,15.0
11138,4933,6205,29187,39741.0,39960.0,20662.0,,,16335.0,24374,4136,26292,3638,50666,7774,29187,106.8,82.0,29187,76.7,59.0
106821,44437,62384,29189,59755.0,68469.0,38698.0,42890.0,82545.0,48561.0,423435,45306,477858,42847,901293,88153,29189,69.0,854.0,29189,45.9,574.0
3808,1786,2022,29195,40101.0,40827.0,26699.0,,,37056.0,10359,1083,10451,987,20810,2070,29195,74.3,22.0,29195,52.1,16.0
914,407,507,29197,37500.0,37500.0,,,,,1662,454,1855,372,3517,826,29197,64.2,4.0,29197,70.0,4.0
730,279,451,29199,39772.0,39798.0,,,,,1613,778,1806,581,3419,1359,29199,58.0,4.0,29199,53.8,4.0
7492,3283,4209,29201,39162.0,41102.0,28083.0,,,28250.0,16351,2471,17253,2522,33604,4993,29201,99.0,49.0,29201,73.8,36.0
1938,808,1130,29203,32404.0,34736.0,,21311.0,,,3358,716,3501,678,6859,1394,29203,70.3,9.0,29203,57.8,7.0
1092,466,626,29205,39087.0,39247.0,,,,,2474,497,2554,447,5028,944,29205,71.9,7.0,29205,39.6,3.0
4583,1898,2685,29207,38203.0,38544.0,30461.0,,,46250.0,12035,2363,12921,2117,24956,4480,29207,93.4,39.0,29207,71.2,30.0
5147,2154,2993,29209,40510.0,40720.0,,21458.0,,39907.0,12806,2449,13343,2523,26149,4972,29209,66.5,39.0,29209,50.0,28.0
1066,407,659,29211,40197.0,39549.0,63750.0,,75000.0,43281.0,2783,488,2689,495,5472,983,29211,88.6,8.0,29211,54.6,5.0
9825,4609,5216,29213,38357.0,38264.0,46223.0,52969.0,,32845.0,20078,5674,21802,5549,41880,11223,29213,80.6,58.0,29213,52.4,38.0
5214,2506,2708,29215,35088.0,35268.0,,50313.0,,,9999,1996,10373,1902,20372,3898,29215,71.0,26.0,29215,56.1,21.0
3764,1645,2119,29217,40693.0,40493.0,,,,8750.0,7993,1875,8945,1590,16938,3465,29217,75.9,21.0,29217,61.9,17.0
4507,2131,2376,29219,51133.0,52289.0,30733.0,75417.0,,30699.0,14369,2102,14662,1732,29031,3834,29219,76.0,30.0,29219,56.9,22.0
5030,2223,2807,29221,35305.0,35410.0,10536.0,14219.0,,,10110,1857,10145,1849,20255,3706,29221,93.0,28.0,29221,81.1,24.0
2960,1342,1618,29223,33750.0,34215.0,,,,,5477,1115,5609,1054,11086,2169,29223,114.9,25.0,29223,87.9,19.0
6733,3198,3535,29225,44451.0,44887.0,,44583.0,85833.0,42682.0,14141,3790,14511,3378,28652,7168,29225,73.9,30.0,29225,49.0,19.0
294,127,167,29227,45952.0,46131.0,,,,,859,147,906,110,1765,257,29227,,2.0,29227,,
4594,2173,2421,29229,29778.0,29153.0,,,,,7116,1859,7620,1657,14736,3516,29229,83.4,21.0,29229,69.4,18.0
83416,37160,46256,29510,35599.0,50042.0,23155.0,33144.0,34193.0,34264.0,122966,27480,138200,24440,261166,51920,29510,88.9,275.0,29510,66.2,204.0
8898,3858,5040,28001,28869.0,41840.0,20921.0,,,47748.0,10865,3146,13122,2483,23987,5629,28001,69.0,29.0,28001,60.6,26.0
7752,3445,4307,28003,36163.0,37419.0,23045.0,,,41111.0,14442,3433,16119,2794,30561,6227,28003,75.7,37.0,28003,59.9,29.0
2852,1314,1538,28005,30704.0,35787.0,21829.0,,,,5265,1026,5465,971,10730,1997,28005,56.9,11.0,28005,51.1,10.0
4908,1796,3112,28007,32886.0,43036.0,21643.0,,,,7498,1341,8869,1160,16367,2501,28007,62.5,17.0,28007,57.3,15.0
1764,886,878,28009,33141.0,39628.0,24946.0,,,,3398,676,3619,696,7017,1372,28009,61.8,7.0,28009,46.1,5.0
11900,5142,6758,28011,27585.0,52659.0,20614.0,,,14746.0,11911,3314,15085,2666,26996,5980,28011,76.2,27.0,28011,66.2,23.0
3763,1682,2081,28013,31098.0,35525.0,22689.0,,,20500.0,5841,1212,6498,1086,12339,2298,28013,88.1,17.0,28013,75.9,15.0
2086,839,1247,28015,37289.0,41287.0,24167.0,,,,4276,770,4524,580,8800,1350,28015,72.3,11.0,28015,60.1,9.0
4493,1854,2639,28017,30926.0,36250.0,23902.0,,,57813.0,6650,1511,7634,1291,14284,2802,28017,78.4,16.0,28017,63.7,13.0
2147,862,1285,28019,30692.0,40731.0,17872.0,,,26250.0,3352,659,3784,459,7136,1118,28019,44.4,5.0,28019,42.1,5.0
3685,1830,1855,28021,23259.0,51051.0,17500.0,,,20833.0,3398,910,4110,858,7508,1768,28021,93.3,10.0,28021,53.9,6.0
3460,1429,2031,28023,35993.0,46437.0,22930.0,,,,6669,1016,7430,1191,14099,2207,28023,75.0,17.0,28023,67.3,15.0
5302,2240,3062,28025,31669.0,57193.0,20377.0,,,23333.0,7804,1453,9273,1464,17077,2917,28025,78.5,20.0,28025,60.8,15.0
8420,3418,5002,28027,28851.0,53536.0,21972.0,,35294.0,30958.0,9445,2065,11366,2085,20811,4150,28027,76.3,21.0,28027,61.8,17.0
7629,3440,4189,28029,35130.0,45843.0,23882.0,,,,10959,2943,12458,2411,23417,5354,28029,86.2,30.0,28029,59.5,20.0
5162,2139,3023,28031,31631.0,36733.0,24375.0,,,35294.0,7549,1596,8578,1499,16127,3095,28031,78.0,19.0,28031,44.8,11.0
16338,6777,9561,28033,58278.0,61612.0,46600.0,,58281.0,41487.0,70131,11179,75876,10577,146007,21756,28033,78.4,118.0,28033,58.5,85.0
20179,9239,10940,28035,36416.0,48568.0,22224.0,,,21113.0,28939,6894,33998,5750,62937,12644,28035,84.2,61.0,28035,63.6,46.0
1464,703,761,28037,38170.0,45481.0,28241.0,,,,3170,621,3314,672,6484,1293,28037,49.9,5.0,28037,35.2,4.0
4154,1784,2370,28039,44258.0,47404.0,27944.0,,,,9247,1973,9214,2200,18461,4173,28039,74.7,19.0,28039,76.9,18.0
1566,553,1013,28041,40176.0,43460.0,31094.0,,,,4221,945,4659,995,8880,1940,28041,46.1,7.0,28041,45.9,7.0
4733,2254,2479,28043,31779.0,40365.0,21846.0,,,,8671,1336,9911,1348,18582,2684,28043,93.4,25.0,28043,74.2,20.0
9807,4704,5103,28045,43355.0,45150.0,29918.0,,43618.0,49837.0,17172,5111,18887,4307,36059,9418,28045,72.8,41.0,28045,49.8,28.0
39569,17498,22071,28047,41722.0,47544.0,26197.0,45588.0,45635.0,41217.0,72667,18692,79448,17720,152115,36412,28047,89.5,179.0,28047,67.5,132.0
61498,26487,35011,28049,37324.0,56242.0,31541.0,18158.0,45900.0,27754.0,92795,20840,110849,18840,203644,39680,28049,75.4,178.0,28049,46.4,110.0
7860,3472,4388,28051,20732.0,32260.0,18773.0,,,,7016,1885,8096,1636,15112,3521,28051,95.0,19.0,28051,62.2,13.0
3508,1539,1969,28053,23216.0,33958.0,19003.0,,,62679.0,3399,831,3738,929,7137,1760,28053,72.3,7.0,28053,54.9,5.0
411,234,177,28055,23491.0,32500.0,18333.0,,,,452,122,392,54,844,176,28055,,2.0,28055,,
4207,2133,2074,28057,35004.0,35406.0,30726.0,,,73977.0,9983,1592,10393,1248,20376,2840,28057,95.6,28.0,28057,68.9,20.0
21400,9488,11912,28059,48406.0,53190.0,31080.0,50978.0,61944.0,45348.0,56066,12275,59214,11759,115280,24034,28059,75.8,116.0,28059,61.3,92.0
3944,1645,2299,28061,31578.0,40903.0,26858.0,,,,6799,1160,7498,1015,14297,2175,28061,78.7,18.0,28061,52.0,12.0
3490,1504,1986,28063,20743.0,52414.0,19124.0,,,,2776,509,3353,521,6129,1030,28063,77.7,7.0,28063,59.7,5.0
4028,1624,2404,28065,26279.0,32228.0,22818.0,,,,4525,1117,4954,1234,9479,2351,28065,68.6,12.0,28065,55.0,9.0
15197,6073,9124,28067,37143.0,44334.0,21745.0,,123917.0,,28118,4544,29379,5481,57497,10025,28067,62.9,50.0,28067,56.0,45.0
2841,1127,1714,28069,30056.0,37865.0,23277.0,20983.0,,,3883,763,4280,741,8163,1504,28069,57.0,8.0,28069,48.3,7.0
11903,5486,6417,28071,44643.0,47025.0,38281.0,,48846.0,18906.0,21278,3156,23650,2499,44928,5655,28071,63.6,28.0,28071,50.6,21.0
9748,4503,5245,28073,52035.0,57894.0,34135.0,,51620.0,31278.0,23481,4500,25482,4475,48963,8975,28073,62.7,33.0,28073,41.7,21.0
17325,6745,10580,28075,38132.0,51134.0,24369.0,,51154.0,68646.0,30735,5094,34787,5848,65522,10942,28075,70.4,65.0,28075,53.0,49.0
2769,1275,1494,28077,35634.0,42552.0,22025.0,,,,5157,1011,5309,1096,10466,2107,28077,106.0,17.0,28077,76.0,12.0
6034,2548,3486,28079,33452.0,37326.0,26563.0,53147.0,,33480.0,8559,2216,9134,2293,17693,4509,28079,75.0,20.0,28079,73.6,19.0
15327,6413,8914,28081,42784.0,50447.0,26571.0,,88407.0,40278.0,34316,5627,38624,5447,72940,11074,28081,91.3,83.0,28081,84.5,77.0
12558,5473,7085,28083,24233.0,41980.0,17283.0,,77279.0,37740.0,11343,3248,13590,2675,24933,5923,28083,82.3,26.0,28083,67.7,22.0
9091,3751,5340,28085,36473.0,42102.0,22590.0,,,,13904,2489,14956,2823,28860,5312,28085,68.5,28.0,28085,51.8,21.0
13675,5540,8135,28087,40239.0,56538.0,22776.0,,,47375.0,22830,4314,25998,4761,48828,9075,28087,70.2,45.0,28087,56.4,37.0
13287,5430,7857,28089,64376.0,83939.0,41272.0,73043.0,83688.0,37083.0,42518,4619,47943,3948,90461,8567,28089,70.9,64.0,28089,87.4,78.0
7156,3313,3843,28091,30668.0,36550.0,21083.0,,,,10094,2173,10761,2325,20855,4498,28091,81.8,27.0,28091,63.7,21.0
6513,2947,3566,28093,37419.0,42446.0,31437.0,,,45417.0,13625,3139,15270,3070,28895,6209,28093,80.6,34.0,28093,70.1,29.0
7123,2940,4183,28095,36783.0,43892.0,27783.0,,,60106.0,14672,2389,16099,2600,30771,4989,28095,81.6,38.0,28095,57.1,26.0
3058,1215,1843,28097,30146.0,45660.0,19194.0,,,,4323,547,4879,598,9202,1145,28097,65.6,10.0,28097,57.0,8.0
6957,3071,3886,28099,35645.0,39169.0,26051.0,40372.0,,,11396,2592,12623,2524,24019,5116,28099,59.2,19.0,28099,58.3,19.0
4737,1955,2782,28101,37045.0,44917.0,26809.0,25329.0,,70766.0,8499,1583,9843,1548,18342,3131,28101,68.2,18.0,28101,54.5,14.0
3953,1771,2182,28103,26677.0,47692.0,18990.0,,,,4081,1140,4761,964,8842,2104,28103,57.8,8.0,28103,52.2,7.0
14780,7021,7759,28105,32485.0,41204.0,21856.0,56484.0,35304.0,32083.0,21214,3109,21499,2799,42713,5908,28105,51.9,20.0,28105,42.9,16.0
7793,3400,4393,28107,36555.0,47752.0,30316.0,,,24208.0,13551,2876,15501,2246,29052,5122,28107,75.2,29.0,28107,73.8,28.0
11590,4999,6591,28109,40976.0,42584.0,22280.0,,,43889.0,21467,5306,22456,5103,43923,10409,28109,89.0,60.0,28109,70.0,47.0
2287,865,1422,28111,34045.0,36845.0,25451.0,,,,4383,1495,5138,1067,9521,2562,28111,81.6,12.0,28111,58.6,8.0
11334,4633,6701,28113,31677.0,44447.0,23046.0,,71125.0,35921.0,15503,3132,17909,2925,33412,6057,28113,78.4,38.0,28113,63.1,30.0
4903,2537,2366,28115,40645.0,41974.0,32869.0,,,38066.0,11979,3300,12552,2433,24531,5733,28115,80.5,27.0,28115,60.4,20.0
5112,2431,2681,28117,32945.0,36938.0,24400.0,,,,10214,2063,11030,1784,21244,3847,28117,82.4,26.0,28117,78.2,24.0
2982,1280,1702,28119,24583.0,41580.0,19396.0,,,,2771,848,3192,776,5963,1624,28119,75.1,7.0,28119,66.1,6.0
14067,5528,8539,28121,58801.0,62228.0,42906.0,40000.0,85043.0,49542.0,58718,8313,66576,7485,125294,15798,28121,76.4,111.0,28121,46.9,67.0
7743,3362,4381,28123,32935.0,43053.0,24994.0,,,31901.0,10538,2999,11649,2843,22187,5842,28123,87.3,27.0,28123,64.3,19.0
1380,607,773,28125,30525.0,60625.0,23946.0,,,49375.0,1542,565,2224,376,3766,941,28125,55.8,3.0,28125,62.4,4.0
6985,3372,3613,28127,35375.0,40999.0,26273.0,,,32279.0,10553,2396,11369,2450,21922,4846,28127,85.9,28.0,28127,60.5,20.0
3813,1606,2207,28129,32951.0,39636.0,24442.0,,,,6684,1116,7253,1117,13937,2233,28129,61.9,13.0,28129,65.8,14.0
3103,1626,1477,28131,45025.0,50741.0,32097.0,,,,7048,1645,7318,1406,14366,3051,28131,82.2,16.0,28131,71.8,13.0
8458,3444,5014,28133,27384.0,48000.0,23418.0,,,,8412,2549,10925,2264,19337,4813,28133,65.0,18.0,28133,59.8,17.0
2609,881,1728,28135,29731.0,40991.0,25030.0,,,,3552,962,5273,726,8825,1688,28135,81.1,13.0,28135,67.1,11.0
4656,2196,2460,28137,42880.0,53820.0,28000.0,,,41230.0,11062,2487,12572,1817,23634,4304,28137,87.8,27.0,28137,69.3,22.0
5311,2352,2959,28139,35609.0,37852.0,24429.0,,,,9246,1568,9666,1471,18912,3039,28139,71.8,19.0,28139,52.8,14.0
3146,1342,1804,28141,35143.0,35861.0,19018.0,,223500.0,45110.0,7612,1654,8535,1478,16147,3132,28141,78.4,22.0,28141,56.2,16.0
2824,999,1825,28143,31211.0,44634.0,28416.0,,,,3816,1036,4686,817,8502,1853,28143,84.2,8.0,28143,56.6,5.0
6170,2262,3908,28145,35865.0,39277.0,25560.0,,,28101.0,10912,2427,11947,2257,22859,4684,28145,72.4,23.0,28145,51.6,17.0
4199,1956,2243,28147,31384.0,45658.0,19375.0,,,,6014,1282,5852,1690,11866,2972,28147,50.8,10.0,28147,57.4,11.0
10768,4265,6503,28149,41121.0,57122.0,27481.0,,29459.0,,18641,3958,21323,3671,39964,7629,28149,73.7,41.0,28149,56.8,31.0
17586,7493,10093,28151,29144.0,47690.0,22243.0,2499.0,52361.0,,18157,4827,20778,5284,38935,10111,28151,75.8,42.0,28151,63.0,34.0
5509,2334,3175,28153,32557.0,44435.0,19912.0,,,,8352,1605,8995,1494,17347,3099,28153,61.2,15.0,28153,55.6,14.0
2243,977,1266,28155,34448.0,43293.0,13239.0,,,,3951,922,4467,573,8418,1495,28155,90.6,12.0,28155,76.6,10.0
2687,1182,1505,28157,29931.0,42143.0,21729.0,,,,3268,709,3551,812,6819,1521,28157,60.5,7.0,28157,46.7,5.0
5389,2222,3167,28159,33202.0,44525.0,22827.0,48750.0,,31875.0,7620,1061,8191,1373,15811,2434,28159,83.9,21.0,28159,58.1,15.0
2472,1069,1403,28161,36502.0,40300.0,31236.0,,,,5011,965,5613,608,10624,1573,28161,114.7,20.0,28161,78.4,14.0
8017,3652,4365,28163,28961.0,42654.0,19796.0,,69500.0,13281.0,9419,2631,10493,1724,19912,4355,28163,95.3,27.0,28163,59.6,17.0
1446,604,842,30001,41512.0,41149.0,,28875.0,48472.0,35556.0,4070,562,4035,490,8105,1052,30001,52.0,7.0,30001,28.3,4.0
3788,1737,2051,30003,41622.0,49451.0,,32231.0,,42688.0,3687,2775,4007,2551,7694,5326,30003,42.3,5.0,30003,,
1795,839,956,30005,36744.0,43750.0,,26364.0,,60500.0,2153,1076,2308,971,4461,2047,30005,76.8,6.0,30005,,
556,257,299,30007,50115.0,49816.0,,,,,2445,434,2431,332,4876,766,30007,44.9,4.0,30007,,
1137,505,632,30009,49767.0,49520.0,,53333.0,60536.0,,4396,704,4453,647,8849,1351,30009,35.8,6.0,30009,21.3,4.0
141,42,99,30011,45000.0,45000.0,,,,,497,116,459,134,956,250,30011,,2.0,30011,,
12212,5336,6876,30013,45205.0,46409.0,53194.0,19556.0,49438.0,37448.0,32558,5433,35087,5132,67645,10565,30013,66.6,68.0,30013,50.3,51.0
1341,610,731,30015,38521.0,42283.0,,20078.0,101250.0,,2242,661,2344,563,4586,1224,30015,59.1,5.0,30015,,
1298,566,732,30017,48750.0,50087.0,,,,,5149,672,5260,625,10409,1297,30017,70.8,11.0,30017,48.9,9.0
100,30,70,30019,49239.0,49457.0,,,,,844,42,758,80,1602,122,30019,,2.0,30019,,
1210,741,469,30021,52738.0,55830.0,,31318.0,,16469.0,4065,605,3919,437,7984,1042,30021,84.6,11.0,30021,49.4,6.0
1499,739,760,30023,39399.0,39151.0,,40536.0,,,3834,745,3656,487,7490,1232,30023,59.5,9.0,30023,53.1,8.0
198,60,138,30025,53266.0,53548.0,,,,,1353,196,1304,167,2657,363,30025,,2.0,30025,,
1287,592,695,30027,40881.0,41594.0,,,,2499.0,4763,888,4876,721,9639,1609,30027,58.5,12.0,30027,50.5,10.0
12307,5818,6489,30029,47851.0,48161.0,80284.0,34390.0,,44219.0,38210,8056,39283,7180,77493,15236,30029,58.4,65.0,30029,33.4,38.0
12125,6297,5828,30031,55553.0,56415.0,,31548.0,57308.0,37500.0,42674,6272,41109,4917,83783,11189,30031,37.1,29.0,30031,27.8,21.0
96,54,42,30033,39732.0,42083.0,,,,,405,93,441,108,846,201,30033,,2.0,30033,,
4447,1962,2485,30035,29640.0,40585.0,,25000.0,32031.0,,4047,2542,4625,2325,8672,4867,30035,92.4,11.0,30035,62.5,7.0
201,91,110,30037,40938.0,41250.0,,,,,322,42,299,93,621,135,30037,,2.0,30037,,
466,218,248,30039,48512.0,48214.0,,,,,1395,221,1301,225,2696,446,30039,,2.0,30039,,
3400,1581,1819,30041,44633.0,48011.0,,34474.0,,,7002,1317,6551,1519,13553,2836,30041,64.4,11.0,30041,33.2,6.0
1068,531,537,30043,60842.0,61068.0,,,,82833.0,5373,511,4850,599,10223,1110,30043,71.9,11.0,30043,50.1,7.0
281,141,140,30045,44602.0,44943.0,,,,,932,109,775,181,1707,290,30045,,2.0,30045,,
6509,3171,3338,30047,38732.0,40828.0,,31419.0,,38346.0,10614,3612,11416,3344,22030,6956,30047,52.6,21.0,30047,37.4,15.0
7803,3651,4152,30049,56197.0,57445.0,51736.0,30326.0,55083.0,31607.0,28620,3455,29722,2920,58342,6375,30049,65.2,49.0,30049,45.4,34.0
416,174,242,30051,47768.0,47768.0,,,,,987,169,1036,155,2023,324,30051,,2.0,30051,,
3554,1627,1927,30053,35275.0,35022.0,,13646.0,,41250.0,7780,1879,7663,1845,15443,3724,30053,71.4,24.0,30053,56.8,18.0
151,78,73,30055,40750.0,40750.0,,,,,835,84,748,39,1583,123,30055,,2.0,30055,,
820,408,412,30057,46250.0,46552.0,,,,,3376,685,3131,515,6507,1200,30057,44.9,6.0,30057,31.3,4.0
265,77,188,30059,41641.0,42083.0,,40313.0,,,737,150,826,160,1563,310,30059,97.1,3.0,30059,,
721,331,390,30061,36031.0,35906.0,,,45750.0,,1591,509,1767,319,3358,828,30061,66.4,5.0,30061,56.9,4.0
17414,8279,9135,30063,46164.0,47284.0,21406.0,31417.0,50425.0,32557.0,46957,8965,48368,7019,95325,15984,30063,56.9,61.0,30063,42.0,45.0
774,324,450,30065,39517.0,39929.0,,,,95875.0,2075,297,2021,363,4096,660,30065,82.0,6.0,30065,66.6,5.0
1918,828,1090,30067,43932.0,44585.0,,,,46000.0,6335,1508,6846,929,13181,2437,30067,42.8,9.0,30067,22.8,5.0
30,12,18,30069,43750.0,43750.0,,,,,169,63,147,64,316,127,30069,,2.0,30069,,
651,274,377,30071,36071.0,34603.0,,39479.0,,32961.0,1612,466,1678,371,3290,837,30071,53.2,4.0,30071,54.2,4.0
1283,676,607,30073,42264.0,46944.0,,25893.0,107917.0,,2449,589,2625,471,5074,1060,30073,66.3,6.0,30073,40.4,3.0
155,71,84,30075,46346.0,44722.0,,71250.0,,81250.0,709,118,696,147,1405,265,30075,,2.0,30075,,
735,319,416,30077,40000.0,40288.0,,,,,2370,414,2215,372,4585,786,30077,85.3,8.0,30077,44.0,4.0
239,113,126,30079,42383.0,44688.0,,,,,608,118,571,56,1179,174,30079,,2.0,30079,,
7308,3338,3970,30081,39480.0,39869.0,,17059.0,,42500.0,16273,3831,17080,3386,33353,7217,30081,48.9,31.0,30081,33.0,21.0
1264,547,717,30083,65084.0,65560.0,,72321.0,,48382.0,4632,1067,4405,1028,9037,2095,30083,78.6,10.0,30083,43.1,5.0
3007,1383,1624,30085,32974.0,50387.0,,22018.0,124375.0,,3768,1672,4041,1373,7809,3045,30085,64.2,6.0,30085,33.7,3.0
1893,826,1067,30087,51159.0,60208.0,,26121.0,,55391.0,3493,1025,3560,1191,7053,2216,30087,56.8,5.0,30087,39.5,3.0
2497,1104,1393,30089,32257.0,32350.0,,21875.0,,,4653,1092,4124,1341,8777,2433,30089,62.1,13.0,30089,45.4,9.0
373,165,208,30091,50664.0,54511.0,,9375.0,,,1621,193,1650,112,3271,305,30091,68.0,5.0,30091,59.7,4.0
6771,3228,3543,30093,37749.0,37301.0,,45840.0,,36076.0,14473,2808,14162,2516,28635,5324,30093,56.0,25.0,30093,44.0,20.0
721,312,409,30095,58259.0,57737.0,,,,70273.0,4172,507,4038,512,8210,1019,30095,49.2,7.0,30095,29.7,4.0
458,203,255,30097,50588.0,50221.0,,,,31667.0,1534,226,1665,177,3199,403,30097,70.2,4.0,30097,59.3,4.0
723,348,375,30099,46360.0,47442.0,,23382.0,,34792.0,2544,442,2580,439,5124,881,30099,60.8,6.0,30099,55.7,5.0
866,341,525,30101,44804.0,45868.0,,,,,1838,518,1732,454,3570,972,30101,77.5,5.0,30101,48.7,3.0
178,104,74,30103,41103.0,41765.0,,,,23906.0,388,44,347,33,735,77,30103,,2.0,30103,,
885,432,453,30105,49141.0,50913.0,,40076.0,,26379.0,3234,523,3301,409,6535,932,30105,48.8,6.0,30105,,
410,194,216,30107,32723.0,32656.0,,,,37500.0,885,184,868,145,1753,329,30107,,2.0,30107,,
145,54,91,30109,38553.0,38553.0,,,,,403,73,410,76,813,149,30109,,2.0,30109,,
17250,7477,9773,30111,52802.0,54237.0,27996.0,31414.0,71225.0,32251.0,63566,10886,66659,10258,130225,21144,30111,60.9,105.0,30111,45.0,79.0
29042,13130,15912,37001,41814.0,46497.0,31451.0,22167.0,60982.0,31018.0,61793,11848,68721,11831,130514,23679,37001,71.3,131.0,37001,51.8,95.0
6191,3003,3188,37003,39365.0,39393.0,44750.0,,63750.0,34338.0,15713,2301,16031,1981,31744,4282,37003,75.7,36.0,37003,51.1,24.0
1986,852,1134,37005,36968.0,38681.0,,53276.0,,18059.0,4369,1002,4481,931,8850,1933,37005,62.4,12.0,37005,59.3,11.0
5865,2550,3315,37007,33228.0,43388.0,25400.0,,32000.0,29211.0,9707,2339,10387,1918,20094,4257,37007,80.5,26.0,37007,56.3,18.0
5510,2737,2773,37009,36267.0,36623.0,13750.0,,,21836.0,10685,2605,11580,1983,22265,4588,37009,70.1,30.0,37009,52.1,22.0
2350,1240,1110,37011,37777.0,38525.0,,,,20139.0,6224,1573,6565,1376,12789,2949,37011,65.5,17.0,37011,49.0,13.0
8660,3746,4914,37013,40391.0,46998.0,25176.0,,,26533.0,19022,3482,21646,3048,40668,6530,37013,83.5,58.0,37013,59.1,41.0
4304,2038,2266,37015,30027.0,44634.0,24440.0,60500.0,45625.0,30880.0,7722,1578,8666,1315,16388,2893,37015,69.7,20.0,37015,49.4,14.0
9342,4175,5167,37017,30096.0,40610.0,21756.0,22566.0,,13520.0,13489,2722,15516,2571,29005,5293,37017,64.1,30.0,37017,51.1,25.0
18725,8143,10582,37019,46859.0,49770.0,29439.0,26940.0,71154.0,41891.0,46541,9270,51200,7963,97741,17233,37019,69.8,127.0,37019,56.8,101.0
38256,17640,20616,37021,45167.0,46805.0,26065.0,59263.0,51780.0,26533.0,97521,19497,109819,16677,207340,36174,37021,66.2,211.0,37021,47.0,150.0
17277,7762,9515,37023,39360.0,41010.0,26906.0,55096.0,44107.0,21283.0,35628,7025,38742,5727,74370,12752,37023,83.1,100.0,37023,61.0,73.0
23384,10512,12872,37025,54720.0,59540.0,41394.0,53250.0,112269.0,38015.0,78787,12302,84177,11749,162964,24051,37025,76.9,135.0,37025,53.1,92.0
15765,6956,8809,37027,35763.0,36386.0,20147.0,41250.0,66429.0,28806.0,32631,6954,35162,6149,67793,13103,37027,82.9,89.0,37027,69.1,73.0
803,370,433,37029,58780.0,61602.0,50125.0,,34886.0,,4459,488,4608,432,9067,920,37029,41.1,5.0,37029,25.4,3.0
10056,4547,5509,37031,48457.0,50119.0,24883.0,53125.0,58333.0,30721.0,26963,5127,29397,4961,56360,10088,37031,76.1,77.0,37031,62.9,63.0
4634,2029,2605,37033,37869.0,40880.0,31483.0,,,22228.0,9255,1611,9896,1485,19151,3096,37033,70.4,22.0,37033,50.2,16.0
23629,10699,12930,37035,44376.0,47561.0,27516.0,60769.0,47188.0,27429.0,63444,11588,68560,9556,132004,21144,37035,68.8,126.0,37035,54.0,99.0
9041,4550,4491,37037,56642.0,61378.0,29673.0,,,31062.0,27262,5354,30028,4042,57290,9396,37037,53.0,52.0,37037,38.5,39.0
5319,2403,2916,37039,34662.0,34692.0,12989.0,21528.0,48684.0,,10488,2637,11249,2436,21737,5073,37039,79.1,39.0,37039,57.2,28.0
3832,1747,2085,37041,38759.0,48095.0,20970.0,,,,5740,1163,6529,956,12269,2119,37041,66.1,15.0,37041,59.2,14.0
2235,1007,1228,37043,37076.0,37388.0,,,,24637.0,4078,994,4521,1002,8599,1996,37043,69.3,14.0,37043,50.3,10.0
19156,8012,11144,37045,39453.0,43965.0,24832.0,,105598.0,40729.0,38871,7516,43812,6666,82683,14182,37045,72.3,90.0,37045,59.2,73.0
12768,5572,7196,37047,34949.0,41415.0,23478.0,39103.0,,31616.0,20690,5109,24204,4529,44894,9638,37047,82.6,61.0,37047,63.6,46.0
15664,6578,9086,37049,47985.0,54139.0,30249.0,38730.0,39189.0,38498.0,38039,7825,44473,6620,82512,14445,37049,81.0,103.0,37049,57.0,73.0
54949,22453,32496,37051,44171.0,50065.0,36925.0,34352.0,48420.0,38158.0,115293,19292,143351,18868,258644,38160,37051,73.3,202.0,37051,56.6,154.0
2497,1018,1479,37053,60600.0,61576.0,55625.0,56373.0,,26900.0,9858,2142,10360,1831,20218,3973,37053,78.6,22.0,37053,70.8,18.0
2885,1204,1681,37055,54496.0,55418.0,33500.0,28199.0,,38369.0,13604,3436,14946,2720,28550,6156,37055,66.3,31.0,37055,41.8,18.0
25655,11254,14401,37057,43363.0,45868.0,30735.0,48750.0,78474.0,36238.0,67953,11300,72487,10369,140440,21669,37057,83.9,170.0,37057,61.3,122.0
5210,2384,2826,37059,51527.0,53615.0,35945.0,,,53086.0,17033,2985,18774,2265,35807,5250,37059,81.6,47.0,37059,48.3,27.0
15606,7197,8409,37061,35035.0,41124.0,25208.0,,48669.0,29642.0,21885,6997,24085,5858,45970,12855,37061,62.0,45.0,37061,48.0,34.0
49835,23570,26265,37063,52503.0,63510.0,39332.0,43942.0,61706.0,39025.0,110556,23537,130140,19125,240696,42662,37063,61.1,147.0,37063,46.6,110.0
14210,6021,8189,37065,32659.0,40699.0,28421.0,,,27413.0,20437,4951,24507,4335,44944,9286,37065,65.8,47.0,37065,53.5,38.0
69100,30558,38542,37067,45471.0,53046.0,29527.0,29911.0,72790.0,28590.0,142855,27087,164825,23837,307680,50924,37067,70.9,277.0,37067,52.9,206.0
9603,4247,5356,37069,42685.0,50847.0,27624.0,39175.0,,35335.0,25114,5007,26451,4666,51565,9673,37069,76.3,53.0,37069,58.9,40.0
36027,15570,20457,37071,42429.0,45474.0,31668.0,37829.0,73929.0,30537.0,83675,16824,91558,15628,175233,32452,37071,87.2,211.0,37071,63.1,150.0
1651,683,968,37073,49258.0,51986.0,39180.0,,,35670.0,5023,707,5360,536,10383,1243,37073,51.8,8.0,37073,56.0,9.0
1884,867,1017,37075,34805.0,35828.0,,22400.0,,35268.0,3237,970,3518,861,6755,1831,37075,48.8,7.0,37075,35.3,5.0
8943,4172,4771,37077,50225.0,56272.0,33947.0,64063.0,113068.0,50968.0,22929,3950,25312,2850,48241,6800,37077,82.3,56.0,37077,52.5,35.0
4962,2049,2913,37079,35777.0,40677.0,32725.0,,,23710.0,7809,1790,8255,1427,16064,3217,37079,70.2,17.0,37079,56.9,13.0
86808,37328,49480,37081,45651.0,56719.0,33980.0,47361.0,48382.0,32192.0,200451,37996,230196,34220,430647,72216,37081,70.3,367.0,37081,48.3,251.0
13660,6086,7574,37083,32245.0,45254.0,23531.0,23125.0,53889.0,53897.0,20409,4057,24473,3054,44882,7111,37083,68.9,51.0,37083,52.4,39.0
22094,9986,12108,37085,46353.0,51068.0,34185.0,38200.0,92344.0,35349.0,47081,8855,53827,8332,100908,17187,37085,86.3,93.0,37085,60.2,63.0
10056,4642,5414,37087,42257.0,42510.0,27431.0,,,41354.0,23777,4670,26178,4045,49955,8715,37087,70.2,67.0,37087,47.7,46.0
14984,7217,7767,37089,46448.0,47247.0,23319.0,61362.0,60795.0,26973.0,43911,8840,48683,7206,92594,16046,37089,59.9,109.0,37089,43.5,80.0
5475,2134,3341,37091,33008.0,42870.0,25381.0,24063.0,71389.0,,8458,1524,10779,1411,19237,2935,37091,68.3,22.0,37091,48.4,16.0
11047,4612,6435,37093,41542.0,55712.0,34740.0,29688.0,,37113.0,18294,3161,21943,3481,40237,6642,37093,96.9,34.0,37093,75.3,24.0
890,278,612,37095,42897.0,53348.0,33958.0,,,,1997,458,2152,420,4149,878,37095,83.6,6.0,37095,54.9,4.0
22803,9533,13270,37097,52306.0,55471.0,31184.0,62045.0,86094.0,34778.0,69972,10617,72976,10314,142948,20931,37097,73.9,131.0,37097,52.2,92.0
8139,3911,4228,37099,38015.0,39363.0,22692.0,31806.0,,18239.0,16388,3487,17794,2816,34182,6303,37099,64.9,33.0,37099,50.1,25.0
27086,12599,14487,37101,50512.0,54415.0,39871.0,18628.0,38304.0,30948.0,72358,14182,77916,12270,150274,26452,37101,70.1,116.0,37101,58.4,94.0
2173,889,1284,37103,34005.0,43750.0,23341.0,35536.0,,50147.0,3862,1023,4482,696,8344,1719,37103,86.4,13.0,37103,65.9,10.0
10533,4363,6170,37105,45608.0,51879.0,30547.0,44306.0,69844.0,33104.0,22501,5700,24947,5037,47448,10737,37105,76.6,51.0,37105,54.7,36.0
13401,5724,7677,37107,34717.0,41064.0,26813.0,79792.0,46780.0,26283.0,21830,5509,26143,4306,47973,9815,37107,73.0,57.0,37107,53.2,42.0
12243,5509,6734,37109,49215.0,51369.0,31250.0,35380.0,,41000.0,33425,5657,34528,5400,67953,11057,37109,71.6,65.0,37109,51.8,47.0
8897,4138,4759,37111,35965.0,37085.0,20744.0,,54545.0,36324.0,18526,3360,19508,2625,38034,5985,37111,88.6,54.0,37111,58.1,35.0
6401,2951,3450,37113,39133.0,39966.0,,65536.0,52917.0,30705.0,13028,3366,14225,3072,27253,6438,37113,75.4,46.0,37113,57.9,35.0
3616,1490,2126,37115,37904.0,38289.0,,,,,8835,1533,9401,1025,18236,2558,37115,56.5,18.0,37115,47.0,14.0
5007,2191,2816,37117,35080.0,46131.0,27717.0,,,27118.0,9207,1912,10402,2070,19609,3982,37117,68.0,24.0,37117,47.2,16.0
148326,65072,83254,37119,56854.0,71296.0,39159.0,43292.0,71071.0,39397.0,394554,79148,440912,70014,835466,149162,37119,59.4,452.0,37119,41.9,314.0
2910,1265,1645,37121,37391.0,37558.0,,,,23295.0,6327,1139,6653,1084,12980,2223,37121,81.4,20.0,37121,63.3,16.0
6716,2942,3774,37123,32500.0,37939.0,21250.0,30542.0,56921.0,30689.0,10297,2606,11294,2567,21591,5173,37123,71.3,26.0,37123,49.4,18.0
13808,5800,8008,37125,50998.0,55347.0,25659.0,75625.0,73421.0,33080.0,37266,5229,41237,5632,78503,10861,37125,73.7,108.0,37125,48.5,74.0
17141,7079,10062,37127,42713.0,51941.0,31232.0,37344.0,38750.0,34853.0,37616,6774,41977,6855,79593,13629,37127,72.8,85.0,37127,58.0,68.0
36717,15886,20831,37129,50088.0,54244.0,29279.0,56136.0,77176.0,32443.0,84864,16254,96287,13171,181151,29425,37129,66.2,158.0,37129,48.7,115.0
5658,2269,3389,37131,30429.0,44398.0,22484.0,11944.0,,27813.0,7822,1734,9211,1484,17033,3218,37131,72.4,24.0,37131,56.8,19.0
24916,10709,14207,37133,46335.0,48660.0,36334.0,51552.0,49323.0,40579.0,60931,9861,73645,8594,134576,18455,37133,85.5,101.0,37133,61.5,70.0
20236,8668,11568,37135,59290.0,64065.0,36400.0,37949.0,72632.0,41906.0,58773,6925,66098,6134,124871,13059,37135,57.5,69.0,37135,42.8,50.0
1674,715,959,37137,43444.0,51694.0,24833.0,,65750.0,50239.0,5137,963,5386,863,10523,1826,37137,83.3,19.0,37137,42.2,10.0
7256,2976,4280,37139,45378.0,53724.0,32445.0,,,,15561,2888,17386,2810,32947,5698,37139,68.8,32.0,37139,59.5,27.0
9925,4191,5734,37141,44828.0,51531.0,27000.0,29375.0,,28941.0,21808,4329,23069,4293,44877,8622,37141,70.9,49.0,37141,51.1,36.0
2626,1160,1466,37143,44329.0,47340.0,23326.0,,,21771.0,5224,1107,5893,1157,11117,2264,37143,68.9,15.0,37143,48.2,10.0
7708,3574,4134,37145,42105.0,46875.0,27679.0,37917.0,,24500.0,15990,2909,17796,2138,33786,5047,37145,84.6,42.0,37145,63.4,32.0
42743,18057,24686,37147,41119.0,50251.0,27672.0,76859.0,52750.0,29151.0,69019,12197,79254,12067,148273,24264,37147,62.9,95.0,37147,48.0,71.0
2790,1322,1468,37149,46528.0,48295.0,22292.0,,,46806.0,8521,1162,8990,1384,17511,2546,37149,50.3,19.0,37149,40.8,15.0
24770,11758,13012,37151,41947.0,43258.0,34034.0,38320.0,36344.0,33176.0,57242,12444,60274,11241,117516,23685,37151,86.5,147.0,37151,60.2,103.0
11465,5045,6420,37153,32687.0,38169.0,22797.0,35114.0,,21866.0,17202,4131,19468,3935,36670,8066,37153,85.7,49.0,37153,64.5,37.0
41538,18723,22815,37155,30608.0,38394.0,24404.0,28680.0,34028.0,27823.0,49747,13868,56491,12539,106238,26407,37155,69.2,95.0,37155,58.4,79.0
16968,7168,9800,37157,38126.0,41852.0,27470.0,20556.0,23359.0,28031.0,38006,6007,41536,5754,79542,11761,37157,89.9,113.0,37157,60.2,75.0
24194,10656,13538,37159,43069.0,47425.0,28766.0,,,37112.0,55135,11191,60050,9456,115185,20647,37159,85.9,144.0,37159,58.5,98.0
13077,5970,7107,37161,35630.0,37061.0,25833.0,29191.0,42411.0,38320.0,26825,5113,29291,4740,56116,9853,37161,79.4,76.0,37161,56.3,54.0
16050,7577,8473,37163,35490.0,41177.0,25927.0,31000.0,29375.0,33039.0,24731,6401,26787,5332,51518,11733,37163,77.7,60.0,37163,60.4,46.0
10504,4613,5891,37165,30958.0,42317.0,18483.0,25192.0,50313.0,50500.0,13319,2850,15365,2603,28684,5453,37165,84.5,36.0,37165,63.6,27.0
10356,4702,5654,37167,40910.0,43011.0,23048.0,80086.0,40461.0,26864.0,25359,3955,25850,4026,51209,7981,37167,80.4,64.0,37167,55.8,43.0
7826,3615,4211,37169,40696.0,40912.0,30000.0,50030.0,114063.0,33929.0,19445,3237,20499,3040,39944,6277,37169,90.6,58.0,37169,65.5,41.0
14195,6484,7711,37171,36164.0,36697.0,23427.0,,46154.0,33565.0,29052,6524,31220,5627,60272,12151,37171,82.9,83.0,37171,67.8,68.0
3409,1553,1856,37173,33931.0,38229.0,,22360.0,,,5139,1619,5775,1441,10914,3060,37173,95.5,18.0,37173,66.8,13.0
4017,1819,2198,37175,45114.0,45947.0,38125.0,,,26344.0,12650,3093,13899,2805,26549,5898,37175,53.6,33.0,37175,37.2,23.0
779,326,453,37177,32361.0,35074.0,21074.0,,,36000.0,1415,413,1396,343,2811,756,37177,97.5,6.0,37177,60.0,3.0
21416,10081,11335,37179,65903.0,69282.0,46942.0,54227.0,112669.0,45712.0,91176,13811,95909,11579,187085,25390,37179,62.9,113.0,37179,46.5,80.0
11064,4926,6138,37181,33316.0,44415.0,26095.0,41750.0,46544.0,35920.0,16836,3892,20309,3338,37145,7230,37181,71.0,39.0,37181,53.2,29.0
107687,49166,58521,37183,67309.0,77090.0,44597.0,54904.0,91219.0,42371.0,410336,59667,444583,52804,854919,112471,37183,55.9,406.0,37183,38.8,274.0
4692,2290,2402,37185,34254.0,47514.0,25938.0,25602.0,,30491.0,7584,1876,8704,1288,16288,3164,37185,81.7,26.0,37185,71.8,23.0
2737,841,1896,37187,34538.0,44692.0,23253.0,,,37725.0,5022,764,5787,957,10809,1721,37187,58.6,11.0,37187,45.4,9.0
14726,7773,6953,37189,37656.0,37961.0,50625.0,,,37125.0,23127,2754,23493,2583,46620,5337,37189,51.4,26.0,37189,33.5,17.0
27037,11517,15520,37191,40390.0,49244.0,31059.0,,35968.0,26594.0,48265,9082,53636,8801,101901,17883,37191,76.6,105.0,37191,58.2,79.0
15791,7521,8270,37193,33232.0,33886.0,31173.0,,,26088.0,27936,5578,30011,4561,57947,10139,37193,77.2,75.0,37193,58.5,57.0
18475,8116,10359,37195,39847.0,51198.0,29420.0,,92857.0,33246.0,30989,7122,35996,6337,66985,13459,37195,71.2,71.0,37195,55.8,55.0
7643,3528,4115,37197,37796.0,38488.0,24332.0,,,36838.0,15503,3106,16609,2487,32112,5593,37197,82.2,42.0,37197,52.6,27.0
3775,1653,2122,37199,37484.0,37870.0,37993.0,,,14744.0,6997,1488,7526,1415,14523,2903,37199,86.3,25.0,37199,53.1,15.0
220,90,130,38001,52118.0,55700.0,,,44375.0,,1062,115,1028,86,2090,201,38001,,2.0,38001,,
841,396,445,38003,53141.0,54880.0,,,18932.0,57841.0,4956,505,5111,332,10067,837,38003,64.5,10.0,38003,41.8,7.0
2260,1070,1190,38005,41296.0,50545.0,,28510.0,,59107.0,2752,732,2757,538,5509,1270,38005,59.4,4.0,38005,,
100,49,51,38007,70469.0,71719.0,,,,,506,76,349,38,855,114,38007,,2.0,38007,,
540,188,352,38009,56349.0,57031.0,,23938.0,,,3109,328,2722,306,5831,634,38009,58.3,6.0,38009,37.8,5.0
234,80,154,38011,66845.0,66488.0,,,,83393.0,1461,91,1505,99,2966,190,38011,81.7,4.0,38011,,
301,124,177,38013,60096.0,60096.0,,,,28942.0,1040,168,869,130,1909,298,38013,,2.0,38013,,
6946,3052,3894,38015,65254.0,66945.0,48958.0,20046.0,99291.0,44286.0,39076,3389,41128,2750,80204,6139,38015,52.2,49.0,38015,34.4,32.0
19082,8990,10092,38017,53289.0,55676.0,28045.0,26822.0,35690.0,34099.0,73605,7721,74144,5868,147749,13589,38017,59.8,80.0,38017,37.3,50.0
180,43,137,38019,66806.0,66250.0,,36136.0,,,1834,94,1812,54,3646,148,38019,50.3,4.0,38019,,
400,151,249,38021,53750.0,54545.0,41250.0,55809.0,,31827.0,2339,243,2279,188,4618,431,38021,49.6,4.0,38021,,
178,72,106,38023,56042.0,56417.0,,,,,1048,109,1000,100,2048,209,38023,,2.0,38023,,
517,246,271,38025,69732.0,76484.0,,42596.0,,58750.0,1790,412,1626,315,3416,727,38025,,2.0,38025,,
311,166,145,38027,48583.0,49896.0,,38500.0,,,992,102,1137,65,2129,167,38027,,2.0,38027,,
386,166,220,38029,44051.0,43168.0,,,,,1597,129,1536,146,3133,275,38029,43.3,3.0,38029,,
316,107,209,38031,55769.0,55962.0,,,,,1528,127,1542,103,3070,230,38031,,2.0,38031,,
177,68,109,38033,40179.0,40179.0,,,,,692,148,833,94,1525,242,38033,,2.0,38033,,
11223,5076,6147,38035,48676.0,50367.0,27083.0,24551.0,51719.0,56310.0,31352,2691,30830,2197,62182,4888,38035,59.7,36.0,38035,42.6,26.0
346,143,203,38037,44559.0,45000.0,,42917.0,,,1021,126,1066,110,2087,236,38037,,2.0,38037,,
179,78,101,38039,48355.0,50956.0,,,,,1047,98,1002,91,2049,189,38039,,2.0,38039,76.8,4.0
217,70,147,38041,52169.0,52243.0,,,,,1145,96,1135,83,2280,179,38041,,2.0,38041,,
185,86,99,38043,54559.0,54804.0,,,,38050.0,1144,135,1080,71,2224,206,38043,,2.0,38043,,
383,152,231,38045,54821.0,55347.0,,,,,1920,195,1838,91,3758,286,38045,,2.0,38045,,
151,62,89,38047,51458.0,51042.0,,,,,867,46,916,41,1783,87,38047,,2.0,38047,,
738,333,405,38049,57386.0,57799.0,,,,27000.0,2706,302,2545,185,5251,487,38049,63.6,6.0,38049,41.7,4.0
311,80,231,38051,42277.0,43333.0,,,,,1236,58,1312,41,2548,99,38051,,2.0,38051,,
1309,670,639,38053,72794.0,82838.0,,32500.0,,,3968,1083,3710,788,7678,1871,38053,43.5,3.0,38053,,
1072,441,631,38055,55686.0,56065.0,,47750.0,,,4285,392,4129,455,8414,847,38055,53.4,8.0,38055,35.1,5.0
693,217,476,38057,72704.0,73260.0,,38889.0,43750.0,92125.0,4014,424,3668,415,7682,839,38057,50.6,6.0,38057,36.8,4.0
2270,1079,1191,38059,62418.0,63120.0,30903.0,63333.0,,56827.0,13459,1052,13184,743,26643,1795,38059,68.7,24.0,38059,45.2,16.0
1226,608,618,38061,68188.0,71691.0,,51193.0,,68380.0,4094,916,3434,711,7528,1627,38061,70.9,6.0,38061,48.9,4.0
249,105,144,38063,51085.0,50991.0,,32361.0,,,1391,146,1300,129,2691,275,38063,71.9,4.0,38063,,
137,66,71,38065,60278.0,60139.0,,66458.0,,,834,110,795,80,1629,190,38065,,2.0,38065,,
454,193,261,38067,53504.0,54531.0,,25625.0,,38250.0,3282,335,3222,203,6504,538,38067,65.2,8.0,38067,56.7,7.0
693,307,386,38069,42563.0,42750.0,,,,,1806,305,1965,128,3771,433,38069,41.0,3.0,38069,,
1118,565,553,38071,50841.0,51556.0,,41016.0,,66121.0,4968,632,4974,491,9942,1123,38071,73.7,11.0,38071,53.2,8.0
490,191,299,38073,56500.0,56446.0,,31339.0,,,2547,172,2450,132,4997,304,38073,67.9,6.0,38073,55.3,5.0
186,85,101,38075,65125.0,66063.0,,,,,1192,65,1158,66,2350,131,38075,,2.0,38075,,
1633,659,974,38077,55390.0,56304.0,,,,39028.0,7869,465,7377,436,15246,901,38077,45.2,9.0,38077,33.2,6.0
5054,2207,2847,38079,33277.0,45903.0,,27191.0,,,4522,2528,5293,2031,9815,4559,38079,76.5,10.0,38079,72.2,9.0
222,80,142,38081,57125.0,57042.0,,,,56429.0,1933,97,1740,67,3673,164,38081,100.0,6.0,38081,,
209,65,144,38083,48102.0,48287.0,,,,,618,50,626,43,1244,93,38083,,2.0,38083,,
1524,717,807,38085,38068.0,59375.0,,33672.0,,45000.0,1431,752,1664,486,3095,1238,38085,,2.0,38085,,
68,33,35,38087,55000.0,57031.0,,,,,341,35,279,18,620,53,38087,,2.0,38087,,
1866,755,1111,38089,72099.0,73907.0,29525.0,47955.0,2499.0,60633.0,13171,1442,12384,1177,25555,2619,38089,42.7,13.0,38089,32.4,10.0
143,74,69,38091,55833.0,55833.0,,,,,979,55,872,73,1851,128,38091,,2.0,38091,,
2130,854,1276,38093,52359.0,52685.0,,,,65688.0,9124,970,9324,745,18448,1715,38093,56.5,17.0,38093,51.2,16.0
316,126,190,38095,56625.0,62083.0,,,,,1021,92,1061,85,2082,177,38095,,2.0,38095,,
804,436,368,38097,54960.0,56155.0,,21477.0,,,3777,223,3741,156,7518,379,38097,62.0,7.0,38097,41.6,5.0
1112,464,648,38099,49411.0,49766.0,,25625.0,,36681.0,4913,667,4880,367,9793,1034,38099,56.7,10.0,38099,42.8,8.0
4919,1861,3058,38101,61393.0,61980.0,61863.0,21612.0,,41606.0,28609,3115,29757,2358,58366,5473,38101,64.6,41.0,38101,44.2,29.0
226,110,116,38103,48098.0,48424.0,,,,,1929,180,1857,153,3786,333,38103,40.6,4.0,38103,45.7,4.0
2913,1402,1511,38105,88013.0,90664.0,19520.0,57904.0,,39151.0,14385,1497,11912,1468,26297,2965,38105,53.9,14.0,38105,46.5,12.0
3499,1490,2009,31001,50635.0,50924.0,35096.0,43906.0,,52250.0,13894,1771,14127,1366,28021,3137,31001,62.7,24.0,31001,45.0,18.0
811,353,458,31003,45609.0,45365.0,,,,,2880,305,2920,284,5800,589,31003,51.1,6.0,31003,39.7,4.0
36,19,17,31005,39375.0,40000.0,,,,,194,29,200,25,394,54,31005,,2.0,31005,,
96,30,66,31007,48897.0,49118.0,,,,,355,44,365,56,720,100,31007,,2.0,31007,,
106,61,45,31009,48875.0,49375.0,,,,,214,79,207,51,421,130,31009,,2.0,31009,,
533,208,325,31011,50306.0,50332.0,,,,57500.0,2453,181,2430,211,4883,392,31011,50.2,4.0,31011,,
1886,758,1128,31013,51691.0,51967.0,,21765.0,,39216.0,5247,428,4956,515,10203,943,31013,48.9,7.0,31013,31.2,5.0
220,97,123,31015,40224.0,40353.0,,53750.0,,,894,132,883,103,1777,235,31015,,2.0,31015,,
499,241,258,31017,36078.0,36250.0,,,,,1283,172,1322,257,2605,429,31017,,2.0,31017,,
5978,2737,3241,31019,53624.0,55005.0,21652.0,,16189.0,43438.0,21439,2104,22245,1568,43684,3672,31019,49.3,23.0,31019,36.0,16.0
620,265,355,31021,47429.0,47931.0,,,,32917.0,2967,283,2957,338,5924,621,31021,66.2,7.0,31021,58.7,6.0
682,309,373,31023,51027.0,51498.0,,,,43661.0,3741,371,3701,272,7442,643,31023,48.0,6.0,31023,36.9,5.0
1556,739,817,31025,65619.0,65818.0,,70357.0,,80875.0,11685,773,11691,780,23376,1553,31025,65.5,19.0,31025,50.4,15.0
864,385,479,31027,52250.0,52500.0,,,,25313.0,4089,267,3947,224,8036,491,31027,32.5,5.0,31027,28.2,4.0
337,161,176,31029,52422.0,53365.0,,,,28824.0,1627,243,1704,256,3331,499,31029,77.6,5.0,31029,59.1,4.0
648,175,473,31031,48750.0,49394.0,,21136.0,,,2495,209,2679,328,5174,537,31031,38.1,3.0,31031,36.4,3.0
1150,420,730,31033,53814.0,53584.0,,,,,4538,380,4707,353,9245,733,31033,60.7,8.0,31033,47.2,6.0
580,233,347,31035,51470.0,51740.0,,,,31875.0,2836,362,2704,376,5540,738,31035,54.1,5.0,31035,41.9,4.0
1374,675,699,31037,51367.0,51870.0,43657.0,,,49615.0,4633,786,4333,680,8966,1466,31037,45.9,5.0,31037,33.1,4.0
1071,376,695,31039,50013.0,50672.0,,,,31750.0,4041,437,4058,391,8099,828,31039,41.6,6.0,31039,34.1,5.0
1200,526,674,31041,46468.0,46723.0,,,,35208.0,4558,716,4818,587,9376,1303,31041,48.3,8.0,31041,42.2,7.0
3528,1510,2018,31043,49786.0,54669.0,6760.0,10707.0,56588.0,45793.0,8405,1570,8872,1735,17277,3305,31043,73.0,15.0,31043,53.0,11.0
1428,531,897,31045,41038.0,44259.0,,7004.0,,,3715,645,3960,741,7675,1386,31045,43.8,5.0,31045,28.9,4.0
3618,1439,2179,31047,48329.0,48471.0,44102.0,50833.0,,39250.0,10328,1645,10323,1499,20651,3144,31047,45.9,13.0,31047,36.9,10.0
246,90,156,31049,50962.0,51058.0,,39250.0,,31406.0,824,147,827,127,1651,274,31049,,2.0,31049,,
683,309,374,31051,51223.0,51168.0,,,,44750.0,2521,356,2582,322,5103,678,31051,63.3,6.0,31051,35.5,3.0
4061,1819,2242,31053,49068.0,49435.0,,,58375.0,32939.0,15521,2220,16362,2033,31883,4253,31053,70.2,36.0,31053,51.8,27.0
76738,33674,43064,31055,54659.0,60685.0,27381.0,28438.0,52180.0,39282.0,228496,32282,242959,27736,471455,60018,31055,69.5,338.0,31055,51.0,245.0
151,69,82,31057,42500.0,42386.0,,,,38423.0,873,162,821,121,1694,283,31057,,2.0,31057,,
514,167,347,31059,52316.0,52700.0,,,,,2426,307,2483,249,4909,556,31059,48.1,5.0,31059,40.6,4.0
396,183,213,31061,45905.0,46574.0,,,16250.0,84063.0,1415,124,1370,134,2785,258,31061,,2.0,31061,,
305,113,192,31063,49634.0,49507.0,,,,,1170,127,1120,147,2290,274,31063,,2.0,31063,,
820,337,483,31065,39934.0,40333.0,,,,,2110,248,2178,269,4288,517,31065,65.8,5.0,31065,,
2080,925,1155,31067,50010.0,49569.0,,33563.0,,,9878,830,10192,633,20070,1463,31067,59.5,19.0,31067,40.6,13.0
181,81,100,31069,45845.0,45845.0,,,,,747,136,779,120,1526,256,31069,,2.0,31069,,
193,63,130,31071,43179.0,43750.0,,,,,836,100,877,85,1713,185,31071,,2.0,31071,,
110,44,66,31073,54375.0,54615.0,,,,,848,93,915,82,1763,175,31073,,2.0,31073,,
98,47,51,31075,44750.0,44750.0,,,,,335,57,338,39,673,96,31075,,2.0,31075,,
243,97,146,31077,42904.0,43125.0,,,,,1122,103,1098,120,2220,223,31077,,2.0,31077,,
9092,3927,5165,31079,49252.0,49560.0,30368.0,61055.0,58167.0,36321.0,25029,4904,25624,4458,50653,9362,31079,57.8,38.0,31079,38.9,25.0
780,303,477,31081,59311.0,59567.0,,33958.0,,31538.0,4189,305,4244,219,8433,524,31081,48.0,6.0,31081,34.1,4.0
450,215,235,31083,46766.0,46495.0,,,,34583.0,1610,185,1423,187,3033,372,31083,,2.0,31083,,
68,36,32,31085,44500.0,44450.0,,,,34375.0,475,117,406,86,881,203,31085,,2.0,31085,,
490,237,253,31087,39231.0,39103.0,,,,,1261,194,1179,211,2440,405,31087,,2.0,31087,,
1209,512,697,31089,46728.0,46653.0,,,,31364.0,4599,482,4691,461,9290,943,31089,49.5,8.0,31089,46.6,8.0
123,71,52,31091,37317.0,37647.0,,,,62917.0,286,32,310,26,596,58,31091,,2.0,31091,,
658,333,325,31093,50030.0,50476.0,,,,26750.0,2996,238,2953,140,5949,378,31093,54.1,5.0,31093,43.2,4.0
909,361,548,31095,43008.0,43118.0,,,,,3352,253,3390,325,6742,578,31095,65.2,8.0,31095,50.1,6.0
471,214,257,31097,45429.0,46607.0,,,41625.0,23167.0,1770,187,1845,212,3615,399,31097,97.5,7.0,31097,46.6,3.0
408,181,227,31099,51934.0,52422.0,,,,60978.0,2928,277,2976,285,5904,562,31099,60.8,6.0,31099,47.6,4.0
931,393,538,31101,41781.0,41710.0,,,,31850.0,3516,521,3500,547,7016,1068,31101,49.2,7.0,31101,37.9,5.0
106,41,65,31103,38625.0,39250.0,,,,,342,26,319,24,661,50,31103,,2.0,31103,,
496,205,291,31105,40242.0,39318.0,,,56250.0,21705.0,1535,289,1542,296,3077,585,31105,60.6,4.0,31105,49.9,3.0
1117,426,691,31107,45411.0,48442.0,,30742.0,53750.0,47656.0,3614,462,3751,498,7365,960,31107,59.3,8.0,31107,51.7,8.0
41796,18624,23172,31109,51830.0,54189.0,30184.0,26154.0,40354.0,35569.0,129832,16174,135393,12304,265225,28478,31109,57.3,155.0,31109,41.6,112.0
4488,1775,2713,31111,50194.0,50618.0,,2499.0,46121.0,34636.0,15665,1904,15915,2019,31580,3923,31111,57.1,26.0,31111,44.2,20.0
91,33,58,31113,48281.0,48438.0,,,,,360,51,406,33,766,84,31113,,2.0,31113,,
68,30,38,31115,55417.0,55104.0,,,,,246,26,257,19,503,45,31115,,2.0,31115,,
64,32,32,31117,54306.0,54306.0,,,,,219,4,206,4,425,8,31117,,2.0,31117,,
5119,2075,3044,31119,50218.0,50463.0,,16000.0,230857.0,40474.0,15094,2026,15516,1830,30610,3856,31119,61.4,25.0,31119,40.5,17.0
667,344,323,31121,51012.0,50826.0,,,,40556.0,3455,310,3494,402,6949,712,31121,68.0,8.0,31121,44.9,5.0
550,259,291,31123,45910.0,45972.0,,,,30192.0,2065,358,2051,248,4116,606,31123,71.6,5.0,31123,,
490,253,237,31125,42500.0,42500.0,,,,,1553,218,1588,183,3141,401,31125,,2.0,31125,,
574,300,274,31127,49656.0,50386.0,23077.0,,,,3100,292,3377,281,6477,573,31127,62.5,6.0,31127,37.4,4.0
501,182,319,31129,40488.0,41555.0,,,,,1886,260,1979,184,3865,444,31129,64.8,5.0,31129,45.0,4.0
1696,740,956,31131,50275.0,50725.0,,33152.0,,40054.0,6900,821,7198,634,14098,1455,31131,59.6,13.0,31131,46.7,10.0
446,207,239,31133,41161.0,41369.0,,,,46250.0,1107,261,1173,144,2280,405,31133,60.9,3.0,31133,,
198,46,152,31135,55893.0,55774.0,,,,34000.0,1318,114,1322,129,2640,243,31135,,2.0,31135,,
706,213,493,31137,50404.0,50640.0,,,,34492.0,4142,364,4120,359,8262,723,31137,44.3,6.0,31137,39.1,5.0
417,174,243,31139,54482.0,54447.0,,,,,3276,287,3320,167,6596,454,31139,56.0,6.0,31139,46.2,5.0
2728,1336,1392,31141,56318.0,56916.0,,,,46053.0,14472,1958,14421,1492,28893,3450,31141,54.9,21.0,31141,40.8,16.0
389,184,205,31143,57312.0,57568.0,,,,38750.0,2359,222,2388,187,4747,409,31143,65.7,5.0,31143,48.0,4.0
1118,572,546,31145,42931.0,43472.0,,,,53875.0,4618,689,4948,430,9566,1119,31145,49.5,8.0,31145,46.5,8.0
1557,690,867,31147,42750.0,45697.0,,,,21188.0,3711,319,3732,284,7443,603,31147,60.6,8.0,31147,51.7,7.0
162,48,114,31149,48456.0,48854.0,,,,,582,89,567,127,1149,216,31149,,2.0,31149,,
1492,705,787,31151,51738.0,51875.0,,,62917.0,41667.0,6427,857,6226,541,12653,1398,31151,79.5,12.0,31151,49.8,8.0
10684,4831,5853,31153,70543.0,71796.0,58210.0,,70507.0,56464.0,75886,5603,78430,5281,154316,10884,31153,65.1,81.0,31153,49.9,62.0
2001,911,1090,31155,60854.0,60988.0,,,,41071.0,9715,720,9515,664,19230,1384,31155,60.8,17.0,31155,46.2,13.0
4877,2163,2714,31157,45992.0,46575.0,,,47143.0,34688.0,14776,2704,16164,2443,30940,5147,31157,45.9,22.0,31157,34.6,17.0
1467,738,729,31159,59662.0,60210.0,,,51250.0,46806.0,8006,588,7718,420,15724,1008,31159,44.2,9.0,31159,32.2,7.0
857,426,431,31161,41985.0,42014.0,,26500.0,,,2185,372,2285,353,4470,725,31161,42.2,4.0,31161,,
411,126,285,31163,46366.0,46220.0,,,,60938.0,1379,133,1430,107,2809,240,31163,,2.0,31163,66.1,3.0
156,64,92,31165,41215.0,40799.0,,,,,574,77,549,49,1123,126,31165,,2.0,31165,,
701,298,403,31167,53416.0,53198.0,,,,60455.0,2751,281,2725,310,5476,591,31167,,2.0,31167,,
604,298,306,31169,45741.0,45998.0,,,,,2339,159,2405,125,4744,284,31169,57.9,5.0,31169,,
55,24,31,31171,51000.0,50600.0,,,,,315,41,297,22,612,63,31171,,2.0,31171,,
2090,947,1143,31173,41266.0,53125.0,,32536.0,,24167.0,2351,1050,2548,941,4899,1991,31173,65.1,4.0,31173,55.8,4.0
540,251,289,31175,44612.0,45147.0,,,,,1869,232,1919,190,3788,422,31175,,2.0,31175,,
1880,595,1285,31177,65370.0,65621.0,,,,39679.0,9329,588,9285,867,18614,1455,31177,43.1,11.0,31177,40.4,10.0
1115,644,471,31179,54159.0,59769.0,12276.0,,,,4472,365,4203,345,8675,710,31179,29.3,3.0,31179,,
459,235,224,31181,40256.0,40577.0,,,,35139.0,1593,163,1667,187,3260,350,31181,68.8,5.0,31181,45.9,3.0
61,30,31,31183,46394.0,46394.0,,,,,399,33,375,40,774,73,31183,,2.0,31183,,
1393,621,772,31185,51802.0,52662.0,,,,,6087,621,6010,538,12097,1159,31185,36.8,7.0,31185,28.2,5.0
6214,2893,3321,33001,62159.0,62336.0,100972.0,,,65132.0,25364,3734,27430,3127,52794,6861,33001,65.6,56.0,33001,55.2,46.0
4484,2015,2469,33003,53306.0,53364.0,,70368.0,,52266.0,19928,3653,20392,3124,40320,6777,33003,65.8,53.0,33003,42.9,35.0
8467,3684,4783,33005,57782.0,57817.0,,20000.0,65000.0,31458.0,32472,4282,35847,3084,68319,7366,33005,66.6,63.0,33005,45.4,43.0
4257,1950,2307,33007,42312.0,42417.0,,51250.0,,23021.0,13183,1853,13622,1713,26805,3566,33007,69.9,36.0,33007,54.8,27.0
9609,4252,5357,33009,55762.0,56169.0,,47734.0,62976.0,,38402,5228,40032,4836,78434,10064,33009,56.4,65.0,33009,38.6,44.0
34681,15707,18974,33011,71244.0,71644.0,47284.0,32417.0,100375.0,42753.0,178942,19692,185709,15685,364651,35377,33011,66.2,283.0,33011,46.1,194.0
12840,5578,7262,33013,65983.0,66113.0,53750.0,29196.0,70606.0,83512.0,63596,6756,68239,5583,131835,12339,33013,66.9,118.0,33013,46.6,84.0
16192,7315,8877,33015,81198.0,81718.0,74453.0,57016.0,83531.0,70223.0,134871,11591,140369,10100,275240,21691,33015,72.5,242.0,33015,49.4,163.0
12997,5717,7280,33017,60711.0,61054.0,37063.0,28980.0,58287.0,58080.0,53304,6948,57377,6285,110681,13233,33017,75.0,96.0,33017,53.3,68.0
4099,1959,2140,33019,56032.0,56113.0,101563.0,50912.0,80640.0,75294.0,18333,2630,19593,2148,37926,4778,33019,72.6,44.0,33019,51.7,32.0
40868,18753,22115,34001,54461.0,60848.0,33060.0,,54271.0,41392.0,112340,19078,124944,16097,237284,35175,34001,69.9,230.0,34001,47.9,156.0
67959,29262,38697,34003,85806.0,88041.0,66075.0,41925.0,96776.0,63194.0,391824,53563,426933,48157,818757,101720,34003,50.9,580.0,34003,34.7,402.0
27881,12238,15643,34005,78621.0,81262.0,65759.0,66944.0,106429.0,66202.0,192963,16726,213627,12770,406590,29496,34005,65.1,342.0,34005,44.2,232.0
66802,28813,37989,34007,62185.0,71426.0,41664.0,30750.0,77749.0,37766.0,212875,31229,239130,23082,452005,54311,34007,71.9,406.0,34007,48.9,275.0
9744,4179,5565,34009,57637.0,58911.0,39439.0,70313.0,,37813.0,40486,4651,44888,3602,85374,8253,34009,83.5,136.0,34009,54.9,90.0
25760,11633,14127,34011,49984.0,54392.0,41547.0,40625.0,52778.0,38793.0,59423,10828,66601,8609,126024,19437,34011,73.4,122.0,34011,50.7,84.0
133788,57543,76245,34013,53976.0,80333.0,37254.0,32631.0,105597.0,41603.0,303430,68533,350254,57907,653684,126440,34013,50.9,399.0,34013,37.1,289.0
23200,9915,13285,34015,76727.0,80139.0,57980.0,46427.0,105435.0,51147.0,128535,11903,138803,9679,267338,21582,34015,80.5,250.0,34015,55.5,172.0
114900,50273,64627,34017,59741.0,61384.0,42537.0,42708.0,94360.0,42715.0,258423,69020,272486,59125,530909,128145,34017,48.8,279.0,34017,36.5,206.0
5379,2236,3143,34019,105444.0,106046.0,88047.0,,128611.0,61058.0,56714,3170,60109,2305,116823,5475,34019,54.4,80.0,34019,37.8,55.0
40354,18218,22136,34021,72804.0,82536.0,42170.0,26384.0,130621.0,46585.0,154154,21815,171281,15938,325435,37753,34021,59.1,235.0,34021,38.2,152.0
70908,31792,39116,34023,79593.0,73145.0,64822.0,66713.0,111242.0,54324.0,350206,51055,376132,43310,726338,94365,34023,53.4,459.0,34023,37.0,319.0
46492,20092,26400,34025,85242.0,89948.0,44668.0,28346.0,117334.0,54291.0,273118,31154,295155,25547,568273,56701,34025,63.9,475.0,34025,42.8,317.0
22068,9710,12358,34027,100214.0,100722.0,77681.0,73750.0,121340.0,67771.0,222190,19830,235146,17038,457336,36868,34027,49.6,287.0,34027,34.8,201.0
64795,29231,35564,34029,61994.0,62147.0,53237.0,25474.0,90000.0,54902.0,251605,26431,277128,22954,528733,49385,34029,71.4,645.0,34029,47.7,442.0
83203,37009,46194,34031,59739.0,72024.0,33682.0,51691.0,94406.0,40260.0,199460,45684,221524,37168,420984,82852,34031,53.8,276.0,34031,39.3,202.0
8602,3826,4776,34033,61831.0,67079.0,32740.0,22083.0,82500.0,46838.0,27515,3442,30248,2723,57763,6165,34033,72.8,62.0,34033,48.1,41.0
16479,7340,9139,34035,100667.0,99241.0,76791.0,45729.0,141242.0,70111.0,145888,13951,155658,12324,301546,26275,34035,48.7,171.0,34035,35.3,122.0
8237,3862,4375,34037,86565.0,85990.0,95813.0,110469.0,116856.0,77520.0,65217,6547,67862,4954,133079,11501,34037,64.2,106.0,34037,45.2,74.0
59034,24322,34712,34039,69594.0,81376.0,53858.0,25652.0,114138.0,50100.0,220599,44217,241572,37837,462171,82054,34039,47.9,274.0,34039,35.8,207.0
8394,3681,4713,34041,70471.0,71885.0,71548.0,30409.0,62639.0,51948.0,46651,4979,50057,4518,96708,9497,34041,65.4,85.0,34041,45.6,59.0
128917,59967,68950,35001,47725.0,51836.0,32761.0,32872.0,60831.0,38967.0,272940,52028,296915,44601,569855,96629,35001,39.4,277.0,35001,31.2,216.0
615,177,438,35003,42973.0,43092.0,,,,27132.0,1528,367,1451,228,2979,595,35003,41.2,4.0,35003,,
14013,6312,7701,35005,40630.0,42455.0,30256.0,35536.0,58799.0,34665.0,26078,5891,27592,5260,53670,11151,35005,47.5,36.0,35005,40.9,31.0
7489,3567,3922,35006,34565.0,42707.0,45893.0,27478.0,,35616.0,9819,2968,10636,2213,20455,5181,35006,50.6,15.0,35006,24.7,7.0
2490,1121,1369,35007,32380.0,35025.0,,4558.0,,28608.0,5246,879,5714,702,10960,1581,35007,38.1,9.0,35007,25.3,6.0
10338,4527,5811,35009,41084.0,46239.0,29976.0,30000.0,38988.0,31586.0,19743,4372,20736,3137,40479,7509,35009,46.8,21.0,35009,36.7,17.0
454,227,227,35011,32500.0,36528.0,,,,25577.0,751,141,1002,101,1753,242,35011,,2.0,35011,,
58846,27487,31359,35013,38853.0,39110.0,50718.0,33913.0,41006.0,30930.0,83656,18726,90314,17907,173970,36633,35013,42.6,92.0,35013,33.8,72.0
6237,2460,3777,35015,56618.0,57248.0,61544.0,70714.0,97554.0,47952.0,23842,4068,23388,3791,47230,7859,35015,47.3,29.0,35015,38.3,24.0
5940,2771,3169,35017,38311.0,38832.0,,15161.0,,31556.0,12900,1315,13334,1189,26234,2504,35017,44.7,22.0,35017,30.0,15.0
552,239,313,35019,30772.0,31745.0,5250.0,36250.0,,30980.0,1815,209,1748,150,3563,359,35019,,2.0,35019,,
59,29,30,35021,33393.0,34107.0,,,,33500.0,274,17,246,27,520,44,35021,,2.0,35021,,
1054,443,611,35023,34444.0,35714.0,,,,31698.0,1879,352,1862,430,3741,782,35023,,2.0,35023,,
9859,3934,5925,35025,57533.0,59273.0,40060.0,70724.0,,51966.0,27173,6335,26439,6606,53612,12941,35025,57.7,34.0,35025,40.8,24.0
3271,1479,1792,35027,40708.0,42235.0,,40426.0,,28870.0,8397,1373,8737,1283,17134,2656,35027,45.4,17.0,35027,31.9,11.0
1092,429,663,35028,101934.0,102965.0,,135089.0,100357.0,44844.0,8611,523,8183,510,16794,1033,35028,26.5,7.0,35028,15.8,4.0
7236,3080,4156,35029,27476.0,27561.0,,,,25568.0,9539,2561,10103,2219,19642,4780,35029,56.8,22.0,35029,41.0,15.0
27493,13235,14258,35031,28772.0,50612.0,,23695.0,57917.0,39288.0,23399,12014,26997,11227,50396,23241,35031,13.5,9.0,35031,11.6,7.0
1092,669,423,35033,23822.0,26563.0,,,,23132.0,1699,527,2067,367,3766,894,35033,,2.0,35033,,
14387,6638,7749,35035,39775.0,42728.0,36168.0,28958.0,37986.0,25018.0,24419,4996,26535,4567,50954,9563,35035,58.5,45.0,35035,43.2,33.0
1484,640,844,35037,29113.0,29677.0,19000.0,,,27298.0,3576,613,4109,365,7685,978,35037,62.1,9.0,35037,51.2,7.0
9413,4770,4643,35039,36098.0,35374.0,38750.0,32195.0,71169.0,37923.0,15072,4355,16670,3586,31742,7941,35039,34.8,16.0,35039,30.3,14.0
4918,2164,2754,35041,35546.0,36484.0,18417.0,,,29611.0,7984,1736,8234,1470,16218,3206,35041,55.2,10.0,35041,37.2,7.0
19305,8939,10366,35043,58982.0,61358.0,71012.0,39332.0,66307.0,56246.0,57383,9182,61538,7749,118921,16931,35043,40.4,58.0,35043,30.9,42.0
24755,11972,12783,35045,48671.0,55802.0,,34862.0,56500.0,48734.0,46708,14508,50124,12443,96832,26951,35045,44.0,53.0,35045,30.1,36.0
8093,3544,4549,35047,29237.0,36446.0,,,,28367.0,11235,2535,11977,2358,23212,4893,35047,37.3,14.0,35047,34.4,12.0
22477,10373,12104,35049,54315.0,56387.0,47440.0,42159.0,59716.0,43876.0,56164,13908,63236,11977,119400,25885,35049,31.7,59.0,35049,23.0,42.0
2360,1347,1013,35051,29356.0,30806.0,,27105.0,,28273.0,4718,973,5002,681,9720,1654,35051,55.1,16.0,35051,49.0,14.0
4278,1928,2350,35053,34037.0,34868.0,,16319.0,122083.0,28714.0,7482,1584,7246,1080,14728,2664,35053,47.8,10.0,35053,35.9,7.0
7909,3785,4124,35055,36582.0,40359.0,,31632.0,,31585.0,13285,2640,14135,2679,27420,5319,35055,35.0,16.0,35055,27.5,13.0
4833,2325,2508,35057,32083.0,32880.0,,9323.0,,31069.0,5959,1566,6662,909,12621,2475,35057,49.0,11.0,35057,40.4,9.0
498,176,322,35059,36070.0,36726.0,,,,28889.0,1427,400,1549,346,2976,746,35059,,2.0,35059,,
17604,8399,9205,35061,41703.0,43699.0,43244.0,42500.0,72625.0,34760.0,30560,6254,33613,4273,64173,10527,35061,50.8,42.0,35061,41.9,34.0
3802,1765,2037,32001,47415.0,48172.0,50057.0,55250.0,45417.0,35568.0,9756,1871,9845,1873,19601,3744,32001,,,32001,59.9,18.0
315358,147575,167783,32003,51575.0,54767.0,37604.0,44759.0,60857.0,43244.0,799278,201993,830625,180211,1629903,382204,32003,,,32003,48.1,901.0
4984,2264,2720,32005,58535.0,59891.0,61083.0,26950.0,48553.0,40714.0,19911,3602,20431,2952,40342,6554,32005,,,32005,40.9,32.0
5574,2675,2899,32007,71799.0,73428.0,,43472.0,55714.0,50925.0,22496,3962,20493,3991,42989,7953,32007,,,32007,39.9,15.0
194,53,141,32009,39271.0,42125.0,,,,,387,128,475,146,862,274,32009,,,32009,,
162,106,56,32011,60250.0,60667.0,,,,,652,140,732,140,1384,280,32011,,,32011,,
1762,802,960,32013,65212.0,65508.0,,,,65828.0,7339,1429,6497,1574,13836,3003,32013,,,32013,48.4,7.0
676,349,327,32015,78190.0,79138.0,,,,89750.0,2775,447,2096,590,4871,1037,32015,,,32015,,
631,372,259,32017,44866.0,44717.0,,45260.0,,,2095,415,1919,390,4014,805,32017,,,32017,,
8482,3749,4733,32019,47255.0,47817.0,66607.0,45747.0,47794.0,40012.0,21106,4645,21605,3982,42711,8627,32019,,,32019,61.2,41.0
907,429,478,32021,38923.0,48143.0,,30167.0,,64554.0,1926,446,1816,296,3742,742,32021,,,32021,63.6,5.0
7658,3541,4117,32023,41712.0,42575.0,42656.0,21250.0,,35327.0,17457,3427,17963,3405,35420,6832,32023,,,32023,67.9,52.0
832,350,482,32027,45230.0,46528.0,,,,41071.0,1995,525,1846,413,3841,938,32027,,,32027,61.0,4.0
293,134,159,32029,64832.0,66161.0,,18438.0,,,1493,376,1826,210,3319,586,32029,,,32029,,
65248,30454,34794,32031,52870.0,54480.0,30773.0,42183.0,56760.0,41422.0,176960,39625,183055,32403,360015,72028,32031,,,32031,41.7,182.0
987,381,606,32033,57122.0,58096.0,,52548.0,,68333.0,3873,526,3532,731,7405,1257,32033,,,32033,46.1,6.0
8787,3992,4795,32510,47668.0,47882.0,93036.0,30708.0,74458.0,43972.0,21461,4907,22411,3802,43872,8709,32510,,,32510,51.8,39.0
39349,17368,21981,36001,59887.0,65120.0,32328.0,32083.0,60174.0,32917.0,136092,11096,149544,7079,285636,18175,36001,73.0,258.0,36001,51.2,181.0
7285,3424,3861,36003,42776.0,43010.0,40625.0,31313.0,29250.0,18333.0,21718,2411,21566,1902,43284,4313,36003,76.9,46.0,36003,50.7,30.0
427574,181112,246462,36005,34299.0,41539.0,36712.0,29889.0,47819.0,27906.0,546151,112171,667792,79977,1213943,192148,36005,50.4,641.0,36005,34.5,438.0
33615,15839,17776,36007,46261.0,48347.0,21355.0,26042.0,38906.0,25137.0,87879,8190,93618,5438,181497,13628,36007,61.7,160.0,36007,42.1,111.0
13954,6444,7510,36009,42601.0,43225.0,58194.0,30379.0,49688.0,37292.0,34324,4389,35911,3604,70235,7993,36009,75.8,77.0,36009,50.9,52.0
9010,4089,4921,36011,52082.0,52488.0,50000.0,37000.0,48304.0,41250.0,34015,3875,35593,2514,69608,6389,36011,77.7,79.0,36011,49.5,51.0
23894,10816,13078,36013,42993.0,43717.0,20513.0,14083.0,25781.0,23974.0,58267,5797,61793,4155,120060,9952,36013,67.9,122.0,36013,49.4,90.0
13044,5401,7643,36015,50320.0,51240.0,23077.0,28788.0,84438.0,25938.0,37175,2867,41183,2753,78358,5620,36015,77.0,88.0,36015,56.2,66.0
7741,3403,4338,36017,45668.0,45701.0,,,82813.0,51471.0,21882,2543,22703,1852,44585,4395,36017,71.9,49.0,36017,52.1,35.0
12163,5245,6918,36019,49930.0,50548.0,40231.0,,33333.0,27059.0,35166,2815,37281,1930,72447,4745,36019,95.1,90.0,36019,53.9,50.0
7067,3251,3816,36021,59105.0,61370.0,31579.0,,43472.0,36652.0,27711,2424,28700,1636,56411,4060,36021,79.0,74.0,36021,55.7,52.0
6675,2638,4037,36023,49514.0,50037.0,22375.0,,,40968.0,21754,1994,23643,1182,45397,3176,36023,79.0,43.0,36023,59.1,32.0
6799,3306,3493,36025,43720.0,43757.0,,,34323.0,39542.0,21050,2238,21095,1983,42145,4221,36025,68.9,51.0,36025,46.3,34.0
26229,11831,14398,36027,71904.0,74963.0,44829.0,31979.0,100797.0,53392.0,128932,12845,138223,9320,267155,22165,36027,64.7,226.0,36027,44.0,151.0
134715,59086,75629,36029,51247.0,57499.0,25819.0,31056.0,46587.0,26909.0,407808,30636,449962,21593,857770,52229,36029,76.2,886.0,36029,52.6,620.0
3894,1756,2138,36031,52758.0,52982.0,2499.0,17917.0,41250.0,,16571,1724,17184,1210,33755,2934,36031,68.0,40.0,36031,46.7,28.0
9213,4383,4830,36033,47923.0,48314.0,,34674.0,,110652.0,20904,2679,20771,2095,41675,4774,36033,77.9,46.0,36033,56.4,33.0
9100,4176,4924,36035,46969.0,47583.0,,48696.0,42167.0,,23688,2953,25023,2103,48711,5056,36035,80.0,58.0,36035,47.6,35.0
7748,3521,4227,36037,50880.0,52032.0,14661.0,35859.0,,31962.0,26500,2833,27875,1715,54375,4548,36037,80.4,61.0,36037,58.2,45.0
5813,2342,3471,36039,50278.0,50700.0,38516.0,65625.0,93851.0,38152.0,20501,1739,21459,1697,41960,3436,36039,72.7,51.0,36039,54.1,38.0
609,317,292,36041,48243.0,48885.0,,,,,2029,353,2217,137,4246,490,36041,78.4,7.0,36041,57.6,5.0
9145,4089,5056,36043,46229.0,46545.0,,38000.0,,,27782,3525,30157,1908,57939,5433,36043,71.1,63.0,36043,44.2,39.0
16938,7850,9088,36045,49505.0,50171.0,48918.0,44192.0,52813.0,40511.0,45675,4905,52114,3727,97789,8632,36045,79.6,88.0,36045,50.4,56.0
597404,265335,332069,36047,48201.0,58330.0,41053.0,28333.0,50761.0,36466.0,1049003,174172,1225395,136478,2274398,310650,36047,49.3,1218.0,36047,33.4,824.0
3238,1478,1760,36049,49819.0,50447.0,23690.0,,62500.0,45795.0,12000,1526,12111,1135,24111,2661,36049,62.7,22.0,36049,51.8,18.0
8681,3775,4906,36051,51734.0,52317.0,19174.0,44167.0,,26116.0,28323,2011,30406,1597,58729,3608,36051,67.2,52.0,36051,45.8,36.0
8180,3640,4540,36053,54145.0,54261.0,,36442.0,81806.0,49779.0,32642,2656,35019,1471,67661,4127,36053,79.9,69.0,36053,56.2,49.0
110192,48774,61418,36055,52553.0,59131.0,26950.0,23293.0,54429.0,29340.0,332340,26459,364808,18562,697148,45021,36055,65.2,569.0,36055,46.4,405.0
10053,4433,5620,36057,43764.0,45668.0,37534.0,57917.0,30982.0,24149.0,21624,2545,23046,1810,44670,4355,36057,81.1,53.0,36057,50.7,34.0
82146,35207,46939,36059,99465.0,103536.0,82121.0,41648.0,118893.0,72728.0,595139,56534,648611,44182,1243750,100716,36059,58.4,992.0,36059,34.8,605.0
283590,123922,159668,36061,72871.0,100221.0,32787.0,31056.0,70702.0,33044.0,681115,82373,793398,61737,1474513,144110,36061,50.4,892.0,36061,32.2,573.0
28816,12569,16247,36063,49449.0,52411.0,24420.0,33529.0,37708.0,30986.0,95704,7556,103074,5711,198778,13267,36063,80.1,227.0,36063,56.3,159.0
37760,17386,20374,36065,48246.0,50770.0,25648.0,16204.0,36607.0,21486.0,101852,8753,109110,6067,210962,14820,36065,79.9,245.0,36065,53.0,164.0
69487,31279,38208,36067,55092.0,60251.0,28516.0,42207.0,44679.0,34088.0,205440,17840,226524,13226,431964,31066,36067,78.2,432.0,36067,52.4,289.0
10975,4935,6040,36069,57416.0,58530.0,29933.0,45673.0,,32500.0,48533,4413,52278,2959,100811,7372,36069,72.6,102.0,36069,48.3,67.0
46731,21428,25303,36071,70848.0,74883.0,61972.0,75568.0,105750.0,59298.0,163553,16726,173191,12204,336744,28930,36071,67.8,248.0,36071,46.5,167.0
6173,2836,3337,36073,46359.0,46709.0,35764.0,71136.0,,29167.0,17756,1951,18283,1388,36039,3339,36073,89.8,47.0,36073,65.4,34.0
21615,10192,11423,36075,47860.0,48307.0,,,47969.0,33371.0,54654,5561,56407,3777,111061,9338,36075,92.6,126.0,36075,65.9,88.0
9275,4372,4903,36077,48588.0,48730.0,,55417.0,71346.0,50625.0,26884,2673,29350,1834,56234,4507,36077,66.5,55.0,36077,52.0,43.0
5212,2693,2519,36079,96148.0,97347.0,85257.0,55072.0,125685.0,81429.0,45157,4059,46074,3540,91231,7599,36079,69.0,77.0,36079,45.2,49.0
343834,148985,194849,36081,57720.0,60915.0,59062.0,48106.0,56151.0,50585.0,908912,199532,1019688,158193,1928600,357725,36081,47.8,1161.0,36081,30.4,740.0
19186,8695,10491,36083,60709.0,63032.0,26620.0,,48438.0,40425.0,72733,5474,76458,3465,149191,8939,36083,84.0,157.0,36083,58.4,109.0
58470,26399,32071,36085,73197.0,78239.0,46455.0,56125.0,72381.0,56238.0,207045,19813,227781,13987,434826,33800,36085,66.4,344.0,36085,45.6,233.0
46118,21825,24293,36087,84855.0,87250.0,74939.0,69390.0,112984.0,58658.0,140580,15354,149776,12368,290356,27722,36087,50.2,177.0,36087,32.9,116.0
19494,9391,10103,36089,44705.0,44857.0,68259.0,,43681.0,51827.0,47996,6068,50035,4289,98031,10357,36089,82.4,108.0,36089,60.3,78.0
14583,6435,8148,36091,71496.0,71257.0,55250.0,,100134.0,71563.0,101757,6317,107942,4428,209699,10745,36091,72.2,188.0,36091,52.4,135.0
19028,8584,10444,36093,58114.0,62266.0,27507.0,48182.0,63698.0,28836.0,68218,6160,74298,4396,142516,10556,36093,70.9,135.0,36093,49.4,94.0
3936,1911,2025,36095,51195.0,50889.0,,,87891.0,58750.0,14353,1482,15212,754,29565,2236,36095,65.1,29.0,36095,44.4,20.0
2595,1062,1533,36097,47680.0,47897.0,,42125.0,,52925.0,7916,1114,8390,669,16306,1783,36097,70.3,18.0,36097,58.8,15.0
4081,1817,2264,36099,49292.0,50237.0,21329.0,58472.0,,22685.0,14250,1859,14865,1491,29115,3350,36099,81.3,37.0,36099,46.6,21.0
15888,7157,8731,36101,47280.0,47089.0,37656.0,48214.0,97540.0,48036.0,43195,5104,45215,3995,88410,9099,36101,80.0,104.0,36101,60.0,78.0
103269,45309,57960,36103,88663.0,91451.0,69805.0,53750.0,96420.0,74070.0,658711,72441,702061,52982,1360772,125423,36103,69.7,1195.0,36103,43.8,751.0
12868,6015,6853,36105,50710.0,52599.0,30252.0,60313.0,75125.0,39007.0,32306,4817,33861,3063,66167,7880,36105,71.9,71.0,36105,51.6,51.0
4801,2062,2739,36107,57514.0,57954.0,65313.0,,,53667.0,22472,2139,23751,1473,46223,3612,36107,64.4,44.0,36107,46.2,31.0
18547,8362,10185,36109,52624.0,57433.0,26136.0,33264.0,24722.0,31069.0,47132,3403,50126,2334,97258,5737,36109,57.6,54.0,36109,42.6,40.0
22290,10453,11837,36111,58918.0,60842.0,35326.0,35050.0,54333.0,42773.0,77152,9528,83276,7023,160428,16551,36111,71.5,164.0,36111,48.3,111.0
7685,3218,4467,36113,56798.0,57422.0,26500.0,43750.0,65313.0,50515.0,28599,3065,30686,2238,59285,5303,36113,71.2,66.0,36113,45.8,42.0
8004,3581,4423,36115,51143.0,51109.0,,39063.0,51250.0,28375.0,26765,3041,27667,2246,54432,5287,36115,88.7,71.0,36115,63.1,50.0
11541,5486,6055,36117,50798.0,51394.0,26912.0,,58750.0,46083.0,40840,4148,42943,3420,83783,7568,36117,72.8,84.0,36117,54.1,62.0
90752,39737,51015,36119,83958.0,98072.0,52543.0,53778.0,119372.0,52738.0,407309,52745,455397,38864,862706,91609,36119,53.2,615.0,36119,33.9,397.0
4425,2081,2344,36121,52564.0,52655.0,,80893.0,,60481.0,17208,1597,17779,1163,34987,2760,36121,68.3,34.0,36121,53.2,26.0
3446,1583,1863,36123,49510.0,49971.0,45967.0,,,64000.0,9630,2453,10188,2558,19818,5011,36123,73.2,25.0,36123,52.7,18.0
6832,2970,3862,39001,35560.0,36101.0,,15104.0,,14188.0,11652,2202,12190,1922,23842,4124,39001,87.1,32.0,39001,74.5,27.0
17713,8327,9386,39003,44103.0,47434.0,22473.0,41458.0,79563.0,40595.0,44827,6106,47505,4170,92332,10276,39003,70.4,90.0,39003,53.5,69.0
7569,3496,4073,39005,48003.0,48293.0,,,,49722.0,22362,3470,23713,3127,46075,6597,39005,61.2,41.0,39005,53.5,35.0
19266,8329,10937,39007,40544.0,41424.0,25797.0,18155.0,77784.0,30833.0,41075,6662,43352,5542,84427,12204,39007,79.2,103.0,39007,60.0,78.0
18263,9227,9036,39009,33872.0,34650.0,,,19583.0,,29257,2799,29877,2350,59134,5149,39009,76.6,43.0,39009,63.1,34.0
4010,1627,2383,39011,54274.0,54571.0,,,,29879.0,21176,1386,21370,1430,42546,2816,39011,68.1,40.0,39011,54.4,31.0
9553,4021,5532,39013,43833.0,44091.0,39796.0,38333.0,,39087.0,28812,3352,30819,2786,59631,6138,39013,61.3,60.0,39013,51.0,51.0
6442,2678,3764,39015,45568.0,45251.0,26615.0,,9323.0,59896.0,18406,3112,19983,2198,38389,5310,39015,106.2,58.0,39015,75.1,41.0
50312,21472,28840,39017,57540.0,59769.0,39487.0,36496.0,74183.0,38868.0,163145,17748,173128,15304,336273,33052,39017,75.0,285.0,39017,58.5,221.0
4317,1997,2320,39019,47075.0,47532.0,,,,49205.0,12116,1990,12340,1632,24456,3622,39019,79.7,31.0,39019,53.7,21.0
4756,2217,2539,39021,50974.0,51301.0,35905.0,45875.0,,30333.0,17416,1966,18175,1353,35591,3319,39021,64.0,31.0,39021,56.2,27.0
24419,10932,13487,39023,43625.0,45869.0,27147.0,31300.0,72000.0,31310.0,58470,6984,63812,5794,122282,12778,39023,76.8,139.0,39023,60.7,112.0
21127,9318,11809,39025,60805.0,61086.0,52860.0,59833.0,91012.0,51955.0,88894,9365,92534,8239,181428,17604,39025,85.3,181.0,39025,61.3,127.0
6425,3000,3425,39027,46787.0,47082.0,35714.0,,71316.0,,18135,2474,19000,1970,37135,4444,39027,86.6,42.0,39027,68.2,33.0
15730,6792,8938,39029,44497.0,44474.0,24896.0,,71087.0,37917.0,44011,6434,46550,5526,90561,11960,39029,68.6,101.0,39029,52.3,76.0
5835,2516,3319,39031,41701.0,41814.0,,,,75804.0,15556,2590,15536,2660,31092,5250,39031,74.0,36.0,39031,64.6,31.0
6888,2976,3912,39033,40795.0,40932.0,,,,37727.0,18546,2003,19625,2020,38171,4023,39033,66.6,41.0,39033,54.4,33.0
231823,101682,130141,39035,44190.0,54296.0,26595.0,32750.0,64478.0,33026.0,526859,66437,601157,53215,1128016,119652,39035,68.7,1108.0,39035,51.1,838.0
6846,3045,3801,39037,44632.0,44957.0,,,,34301.0,22865,2645,24022,2213,46887,4858,39037,65.9,46.0,39037,52.7,37.0
5071,2187,2884,39039,50663.0,51628.0,31750.0,26771.0,,43846.0,16977,2192,17511,1679,34488,3871,39039,67.3,32.0,39039,56.6,27.0
8285,3705,4580,39041,91955.0,91973.0,67478.0,91313.0,120546.0,82313.0,86544,4668,89842,3441,176386,8109,39041,61.0,94.0,39041,44.1,66.0
9333,4116,5217,39043,48011.0,50871.0,28489.0,,47841.0,43179.0,32644,4193,35368,3004,68012,7197,39043,65.0,71.0,39043,54.4,59.0
15110,6752,8358,39045,60567.0,60323.0,67900.0,83784.0,71591.0,46855.0,66091,5886,69770,4743,135861,10629,39045,73.6,117.0,39045,54.3,86.0
5185,2461,2724,39047,40503.0,40701.0,37200.0,,82500.0,31813.0,12093,1818,12750,1609,24843,3427,39047,87.4,32.0,39047,67.7,24.0
208422,95908,112514,39049,52341.0,59586.0,32571.0,22340.0,68486.0,37220.0,511117,77423,557121,62162,1068238,139585,39049,70.3,736.0,39049,53.5,553.0
4532,2197,2335,39051,55120.0,56044.0,,51667.0,61932.0,43864.0,19523,1367,20214,999,39737,2366,39051,48.4,25.0,39051,45.3,24.0
6214,2541,3673,39053,37319.0,37946.0,19375.0,39875.0,,,12476,2209,13705,1756,26181,3965,39053,88.7,35.0,39053,67.2,26.0
6969,3258,3711,39055,72430.0,72865.0,57235.0,,107895.0,52910.0,40116,5896,42688,4557,82804,10453,39055,51.4,63.0,39055,35.2,43.0
21065,9574,11491,39057,60113.0,61720.0,37255.0,80357.0,66706.0,55721.0,71331,6600,77789,4516,149120,11116,39057,60.9,113.0,39057,43.5,81.0
7784,3427,4357,39059,40930.0,41395.0,17222.0,,,29231.0,16774,2444,18074,1851,34848,4295,39059,82.2,43.0,39059,70.6,37.0
143778,63809,79969,39061,49013.0,60687.0,25901.0,22138.0,63347.0,40458.0,339523,43509,380210,32950,719733,76459,39061,75.1,673.0,39061,55.7,500.0
10221,4369,5852,39063,50895.0,51183.0,,,59722.0,41724.0,33307,3300,35026,2975,68333,6275,39063,57.9,52.0,39063,48.4,44.0
5491,2667,2824,39065,42703.0,43034.0,,,60469.0,31757.0,13877,1873,13905,1877,27782,3750,39065,72.9,26.0,39065,57.9,21.0
2657,1186,1471,39067,43173.0,43177.0,32604.0,,,82344.0,6814,776,6933,858,13747,1634,39067,72.7,17.0,39067,57.6,14.0
3144,1325,1819,39069,53835.0,54239.0,10972.0,,91250.0,37955.0,12487,1198,13137,831,25624,2029,39069,55.3,20.0,39069,48.2,18.0
8604,3780,4824,39071,39858.0,40181.0,23098.0,,,,18337,2813,18763,2841,37100,5654,39071,75.8,41.0,39071,66.7,36.0
4894,2116,2778,39073,42170.0,42083.0,,,107667.0,,12117,1860,12703,1551,24820,3411,39073,75.9,28.0,39073,66.3,25.0
5398,2451,2947,39075,51996.0,52297.0,,,,34613.0,12699,8654,12058,9249,24757,17903,39075,40.0,16.0,39075,26.3,11.0
7853,3501,4352,39077,48745.0,49245.0,26948.0,40625.0,,33578.0,25591,3298,27087,2445,52678,5743,39077,78.2,54.0,39077,63.3,43.0
7637,3320,4317,39079,39460.0,40088.0,,,,,13973,1942,14869,1741,28842,3683,39079,82.3,33.0,39079,66.2,27.0
11533,4875,6658,39081,41942.0,42899.0,21607.0,,45469.0,,29123,3514,31757,2923,60880,6437,39081,78.6,78.0,39081,58.7,59.0
8825,3995,4830,39083,48533.0,48635.0,,,52794.0,47534.0,25850,3783,27262,3531,53112,7314,39083,69.8,51.0,39083,48.0,35.0
20063,8926,11137,39085,58029.0,59227.0,29156.0,,75775.0,48125.0,101515,9739,107925,8200,209440,17939,39085,73.0,222.0,39085,55.4,169.0
11135,5080,6055,39087,42874.0,43448.0,25991.0,,21721.0,,26399,3593,28448,2803,54847,6396,39087,83.4,66.0,39087,67.8,53.0
20926,9134,11792,39089,56549.0,56635.0,69714.0,40156.0,56600.0,57955.0,74195,7804,77981,7386,152176,15190,39089,78.5,149.0,39089,60.1,113.0
6487,2767,3720,39091,49783.0,50065.0,45465.0,,61016.0,,19176,3129,20589,2276,39765,5405,39091,70.7,40.0,39091,60.0,34.0
42269,17426,24843,39093,52457.0,55261.0,28250.0,29167.0,74417.0,37303.0,130768,13366,141653,10783,272421,24149,39093,71.0,259.0,39093,55.1,200.0
90091,42034,48057,39095,41777.0,48823.0,21855.0,32794.0,51140.0,35328.0,183219,25409,203622,18716,386841,44125,39095,61.9,306.0,39095,55.4,275.0
3580,1621,1959,39097,57406.0,57824.0,45250.0,31250.0,,41250.0,16709,2312,18209,1293,34918,3605,39097,74.8,36.0,39097,52.8,25.0
40841,17922,22919,39099,41375.0,45612.0,21408.0,31019.0,58070.0,29869.0,98779,11550,109376,9338,208155,20888,39099,69.4,232.0,39099,53.4,183.0
11127,4978,6149,39101,42966.0,43940.0,27000.0,65714.0,,34350.0,25849,3294,27630,3027,53479,6321,39101,82.9,67.0,39101,62.2,51.0
12859,5798,7061,39103,66952.0,67277.0,31745.0,53375.0,86607.0,52922.0,79425,6220,82372,5707,161797,11927,39103,62.1,123.0,39103,45.9,90.0
5285,2498,2787,39105,37813.0,37829.0,,,,14028.0,9951,1527,10483,1304,20434,2831,39105,71.8,22.0,39105,51.7,16.0
3399,1428,1971,39107,53099.0,54059.0,,,,36364.0,18786,1591,18863,1252,37649,2843,39107,52.9,28.0,39107,39.8,21.0
13076,5466,7610,39109,51569.0,51658.0,30361.0,120329.0,96830.0,39464.0,45696,4834,48031,4148,93727,8982,39109,73.7,95.0,39109,54.9,72.0
2782,1268,1514,39111,41528.0,41507.0,,,,,6389,842,6423,747,12812,1589,39111,60.3,13.0,39111,54.6,12.0
96354,42909,53445,39113,43829.0,50144.0,27472.0,24545.0,63335.0,37217.0,221306,31005,249399,23700,470705,54705,39113,76.4,507.0,39113,56.3,376.0
3111,1481,1630,39115,37067.0,37258.0,39464.0,,54028.0,91563.0,6195,1159,6417,954,12612,2113,39115,80.5,18.0,39115,64.8,14.0
4063,2119,1944,39117,51993.0,52283.0,,,,88142.0,15638,1728,15715,1616,31353,3344,39117,80.1,34.0,39117,54.2,22.0
15554,7155,8399,39119,41130.0,41844.0,29844.0,,21250.0,,36412,4893,39884,3967,76296,8860,39119,80.6,87.0,39119,69.6,75.0
1521,670,851,39121,41708.0,41646.0,,,,,5243,646,5432,657,10675,1303,39121,48.6,12.0,39121,37.5,9.0
4349,1803,2546,39123,53914.0,54373.0,37333.0,,41016.0,55587.0,18685,1501,19028,1519,37713,3020,39123,66.0,43.0,39123,55.7,35.0
2436,1188,1248,39125,45550.0,45581.0,,,,39911.0,8635,838,8773,817,17408,1655,39125,87.6,21.0,39125,68.9,17.0
6876,2994,3882,39127,42017.0,42319.0,,,,,16107,1826,15993,1823,32100,3649,39127,78.5,33.0,39127,63.3,26.0
6509,3040,3469,39129,57439.0,57523.0,,,250001.0,39000.0,23689,2254,24408,2016,48097,4270,39129,77.5,49.0,39129,64.6,41.0
6436,3038,3398,39131,40283.0,40136.0,85338.0,,,,11707,2310,12640,1357,24347,3667,39131,91.3,33.0,39131,67.8,24.0
24219,10238,13981,39133,52552.0,53792.0,35222.0,57935.0,39702.0,45682.0,71543,7060,75801,6452,147344,13512,39133,72.1,128.0,39133,56.7,100.0
5477,2504,2973,39135,47818.0,47929.0,34722.0,,,,18511,2018,18795,2029,37306,4047,39135,72.2,39.0,39135,57.7,31.0
1966,831,1135,39137,60524.0,61208.0,148281.0,,,42349.0,16179,831,16121,790,32300,1621,39137,45.5,19.0,39137,36.7,15.0
19504,8622,10882,39139,41877.0,43464.0,25978.0,11842.0,90650.0,36172.0,49703,6482,53371,6270,103074,12752,39139,71.5,118.0,39139,56.2,93.0
13746,6062,7684,39141,43345.0,43924.0,37450.0,,,,31008,4216,33149,3191,64157,7407,39141,85.2,79.0,39141,63.9,58.0
8458,3644,4814,39143,47209.0,48595.0,19911.0,,28036.0,38750.0,26820,2648,27470,2397,54290,5045,39143,69.2,53.0,39143,56.2,43.0
18740,8702,10038,39145,35903.0,36247.0,24967.0,19524.0,75104.0,,31964,4628,34529,4037,66493,8665,39145,97.8,96.0,39145,73.2,71.0
8923,4164,4759,39147,45444.0,46817.0,16411.0,,14020.0,33892.0,25100,2377,25497,1961,50597,4338,39147,72.1,49.0,39147,54.0,38.0
4970,2048,2922,39149,54550.0,55131.0,25057.0,46163.0,49924.0,29955.0,22360,2057,22913,1377,45273,3434,39149,55.7,32.0,39149,44.2,24.0
53715,23898,29817,39151,47137.0,49412.0,26899.0,40192.0,85469.0,42409.0,161717,18295,175145,15018,336862,33313,39151,68.1,338.0,39151,51.9,258.0
78658,35036,43622,39153,50765.0,55527.0,27300.0,34167.0,61991.0,43944.0,232858,27322,255090,21505,487948,48827,39153,67.2,449.0,39153,52.3,352.0
34912,15220,19692,39155,43073.0,44862.0,24860.0,,49289.0,30066.0,85163,12942,94128,10463,179291,23405,39155,80.8,237.0,39155,56.5,168.0
12763,5748,7015,39157,45310.0,45333.0,25969.0,35486.0,85606.0,46212.0,39847,5517,41619,4711,81466,10228,39157,61.0,76.0,39157,45.3,56.0
4344,1959,2385,39159,67382.0,66556.0,,60395.0,114844.0,51571.0,23304,1945,23504,1475,46808,3420,39159,68.9,33.0,39159,54.5,26.0
3600,1623,1977,39161,48060.0,48502.0,43370.0,,,44167.0,12572,1307,13315,1101,25887,2408,39161,56.2,21.0,39161,47.1,18.0
2713,1100,1613,39163,40680.0,40896.0,,,,,5730,896,5921,614,11651,1510,39163,114.2,19.0,39163,64.5,11.0
11885,4930,6955,39165,74379.0,73836.0,66111.0,,111173.0,69141.0,98462,6599,103216,5654,201678,12253,39165,65.8,139.0,39165,49.4,102.0
9777,4438,5339,39167,43509.0,44345.0,37935.0,,86000.0,,26597,3277,28123,2685,54720,5962,39167,75.8,67.0,39167,55.5,49.0
14758,6498,8260,39169,50383.0,50526.0,30272.0,43000.0,52500.0,53304.0,48314,8351,49904,7723,98218,16074,39169,57.0,79.0,39169,44.3,62.0
5386,2265,3121,39171,42492.0,42492.0,,57031.0,,49545.0,16155,1681,17156,1254,33311,2935,39171,66.0,32.0,39171,48.2,23.0
17461,8079,9382,39173,53577.0,53636.0,47602.0,,85946.0,51563.0,58179,4587,61220,3660,119399,8247,39173,53.3,73.0,39173,45.0,61.0
2601,1060,1541,39175,47555.0,47278.0,,,,44886.0,9865,1105,10393,840,20258,1945,39175,74.4,22.0,39175,56.3,17.0
5897,2813,3084,40001,33404.0,32542.0,,35000.0,,24813.0,7818,3227,8131,2961,15949,6188,40001,71.5,18.0,40001,52.7,13.0
606,319,287,40003,50156.0,49976.0,,69375.0,,46094.0,2091,355,1982,294,4073,649,40003,61.2,5.0,40003,53.0,5.0
2794,1204,1590,40005,36661.0,37882.0,28347.0,37150.0,36250.0,24615.0,4620,1271,5148,1433,9768,2704,40005,80.2,14.0,40005,49.9,9.0
492,182,310,40007,52090.0,52917.0,,,,44740.0,2319,347,2318,467,4637,814,40007,,2.0,40007,,
2777,1101,1676,40009,48601.0,48711.0,31108.0,,,74067.0,9006,1957,8870,1800,17876,3757,40009,53.8,13.0,40009,44.7,10.0
1293,524,769,40011,41972.0,42679.0,30893.0,,,17480.0,3144,469,3941,527,7085,996,40011,66.4,9.0,40011,48.6,7.0
7816,3424,4392,40013,38847.0,39412.0,30167.0,32955.0,44018.0,30169.0,16794,4402,18231,4136,35025,8538,40013,87.9,48.0,40013,74.0,41.0
5976,2901,3075,40015,40674.0,42953.0,30806.0,31625.0,,36111.0,10739,3495,10819,3197,21558,6692,40015,85.3,30.0,40015,65.4,23.0
8995,3890,5105,40017,64505.0,65112.0,49238.0,61409.0,71250.0,51835.0,54096,6921,57233,6067,111329,12988,40017,70.2,80.0,40017,49.7,56.0
7262,3135,4127,40019,44531.0,46229.0,28368.0,35588.0,62614.0,38393.0,18995,4017,20961,3842,39956,7859,40019,77.6,45.0,40019,64.0,38.0
10426,5020,5406,40021,38694.0,40489.0,21065.0,35514.0,73250.0,21039.0,18034,5459,18325,5702,36359,11161,40021,79.3,41.0,40021,66.4,34.0
4297,1952,2345,40023,30617.0,30794.0,16875.0,37098.0,,40694.0,5331,1895,5919,1797,11250,3692,40023,80.4,17.0,40023,70.6,15.0
414,174,240,40025,46680.0,48889.0,,71250.0,,32031.0,950,204,996,168,1946,372,40025,,2.0,40025,,
32758,15142,17616,40027,56452.0,57687.0,41039.0,51023.0,57823.0,46909.0,113205,16326,119149,14496,232354,30822,40027,66.3,156.0,40027,49.7,116.0
1186,515,671,40029,38243.0,38676.0,,34375.0,,38000.0,2095,743,2242,666,4337,1409,40029,85.8,7.0,40029,81.1,7.0
20444,8810,11634,40031,46241.0,49778.0,36806.0,35368.0,41372.0,46106.0,44938,8863,50108,8306,95046,17169,40031,72.8,80.0,40031,58.2,63.0
1030,467,563,40033,46361.0,51097.0,32125.0,21893.0,,52188.0,2377,585,2497,531,4874,1116,40033,59.8,5.0,40033,63.5,5.0
2659,1162,1497,40035,38876.0,40364.0,25577.0,34875.0,55417.0,38203.0,5675,1233,5666,1430,11341,2663,40035,85.9,18.0,40035,76.6,16.0
10813,4877,5936,40037,45016.0,47196.0,22500.0,39970.0,,36691.0,28847,5822,29842,5449,58689,11271,40037,87.7,78.0,40037,67.1,60.0
4595,2089,2506,40039,46125.0,47572.0,29034.0,45250.0,36339.0,35676.0,11710,2539,11990,2291,23700,4830,40039,71.5,21.0,40039,60.2,18.0
8311,3830,4481,40041,37942.0,40000.0,23875.0,30428.0,52740.0,32583.0,16145,4162,16743,3980,32888,8142,40041,71.3,46.0,40041,57.8,37.0
788,367,421,40043,50904.0,51865.0,,,,47000.0,2008,415,2034,302,4042,717,40043,48.3,4.0,40043,56.5,4.0
595,291,304,40045,50855.0,50987.0,,41250.0,,37188.0,1793,244,1874,184,3667,428,40045,65.8,4.0,40045,50.0,3.0
7852,3563,4289,40047,48238.0,49506.0,37755.0,50036.0,46685.0,40806.0,24926,4571,26885,3714,51811,8285,40047,62.4,46.0,40047,51.8,39.0
5038,2280,2758,40049,40524.0,40610.0,35046.0,42212.0,56912.0,38750.0,11088,2352,11481,2294,22569,4646,40049,87.9,32.0,40049,72.2,26.0
6690,2780,3910,40051,52279.0,53478.0,30469.0,52794.0,,40000.0,22055,4218,22808,3956,44863,8174,40051,67.6,41.0,40051,56.7,35.0
430,156,274,40053,50250.0,50448.0,,24167.0,,60263.0,2010,177,1982,270,3992,447,40053,60.2,4.0,40053,64.0,5.0
735,346,389,40055,40125.0,41349.0,,,,,2078,458,2015,490,4093,948,40055,89.8,7.0,40055,65.0,5.0
481,172,309,40057,31250.0,38083.0,21964.0,81250.0,,18015.0,1104,235,1257,164,2361,399,40057,,2.0,40057,,
520,272,248,40059,48359.0,48691.0,,,,47750.0,1568,307,1643,232,3211,539,40059,76.8,4.0,40059,,
2524,1126,1398,40061,35252.0,35290.0,,36797.0,51000.0,27614.0,4857,1485,4929,1510,9786,2995,40061,75.8,13.0,40061,69.9,12.0
2244,1025,1219,40063,35563.0,36758.0,32500.0,27614.0,,28393.0,4591,1275,4939,1300,9530,2575,40063,88.5,17.0,40063,77.6,15.0
4276,1665,2611,40065,41560.0,44890.0,30684.0,36702.0,62066.0,33347.0,9811,1887,10682,2080,20493,3967,40065,58.6,17.0,40065,58.6,17.0
1313,607,706,40067,33449.0,33715.0,,35313.0,,19010.0,2425,695,2433,636,4858,1331,40067,79.0,7.0,40067,64.3,6.0
2070,777,1293,40069,38776.0,40136.0,9034.0,41818.0,,39583.0,4257,1055,4298,1292,8555,2347,40069,54.9,8.0,40069,60.0,9.0
8137,3467,4670,40071,42134.0,43037.0,18185.0,35000.0,55268.0,32227.0,18064,4099,19228,3530,37292,7629,40071,72.9,45.0,40071,64.7,40.0
1093,481,612,40073,60034.0,60831.0,,73542.0,,52389.0,6676,903,6395,1169,13071,2072,40073,70.4,13.0,40073,54.5,10.0
1883,806,1077,40075,39909.0,41470.0,29583.0,24063.0,,36250.0,3787,676,3804,836,7591,1512,40075,75.1,10.0,40075,66.1,9.0
1833,776,1057,40077,39205.0,41102.0,,30357.0,,31625.0,4119,1194,4221,1032,8340,2226,40077,59.9,9.0,40077,56.4,9.0
11035,4903,6132,40079,36490.0,37389.0,18421.0,33438.0,31520.0,33500.0,18447,5735,19478,5085,37925,10820,40079,62.2,38.0,40079,75.4,47.0
5335,2418,2917,40081,45149.0,46002.0,24375.0,37625.0,,37639.0,14153,2800,14337,2813,28490,5613,40081,66.3,30.0,40081,66.4,29.0
4943,2388,2555,40083,55299.0,60028.0,27348.0,40081.0,250001.0,52448.0,18313,3563,19275,2987,37588,6550,40083,67.4,32.0,40083,50.3,24.0
1292,604,688,40085,44549.0,44626.0,40278.0,44688.0,,40250.0,3860,847,4177,694,8037,1541,40085,57.5,7.0,40085,48.4,6.0
3944,1922,2022,40087,56088.0,55531.0,,63456.0,,56563.0,15556,2496,15845,2338,31401,4834,40087,83.0,32.0,40087,60.1,23.0
8256,3703,4553,40089,32324.0,34778.0,19265.0,31446.0,,24471.0,12335,3672,12912,3806,25247,7478,40089,94.2,39.0,40089,65.6,27.0
4209,1975,2234,40091,36011.0,38664.0,25655.0,30156.0,,39153.0,7958,1904,8188,1922,16146,3826,40091,76.9,26.0,40091,70.1,24.0
1073,456,617,40093,51571.0,53105.0,,32353.0,,30938.0,3355,473,3344,464,6699,937,40093,59.3,6.0,40093,42.7,5.0
2645,1134,1511,40095,40475.0,41250.0,12750.0,32308.0,,44375.0,6309,1554,6322,1597,12631,3151,40095,71.7,18.0,40095,61.9,15.0
8585,3814,4771,40097,42071.0,42318.0,,40219.0,48194.0,38750.0,15800,4325,16888,3557,32688,7882,40097,84.2,44.0,40097,63.9,33.0
2012,764,1248,40099,47077.0,46940.0,,37625.0,,53164.0,5264,1276,5525,1259,10789,2535,40099,97.5,18.0,40099,66.9,13.0
14670,6326,8344,40101,39984.0,41909.0,27149.0,38400.0,70850.0,28882.0,25770,6904,27841,6878,53611,13782,40101,97.9,84.0,40101,74.0,63.0
1515,695,820,40103,48285.0,50219.0,,52031.0,,,4961,617,5314,514,10275,1131,40103,59.7,9.0,40103,48.7,8.0
1928,881,1047,40105,39875.0,41162.0,23958.0,35741.0,,40385.0,4128,968,4379,876,8507,1844,40105,59.7,9.0,40105,54.9,8.0
2797,1344,1453,40107,36216.0,41474.0,24545.0,24959.0,,42955.0,4562,1234,4333,1219,8895,2453,40107,65.3,11.0,40107,64.6,10.0
134377,59501,74876,40109,47437.0,52362.0,31816.0,43039.0,54457.0,35187.0,290614,69706,319677,62086,610291,131792,40109,69.5,513.0,40109,55.9,409.0
7880,3555,4325,40111,38843.0,42123.0,24688.0,33393.0,,36548.0,15883,3339,16422,3157,32305,6496,40111,95.2,48.0,40111,71.9,36.0
7365,3002,4363,40113,45443.0,47252.0,36786.0,41126.0,,33897.0,19240,3500,20344,3542,39584,7042,40113,55.9,36.0,40113,56.0,36.0
7112,3361,3751,40115,36347.0,37140.0,25000.0,35521.0,48125.0,28500.0,12486,3031,13216,2909,25702,5940,40115,80.2,34.0,40115,74.0,32.0
2249,980,1269,40117,45765.0,46325.0,23500.0,41012.0,,61339.0,6814,1378,6761,1390,13575,2768,40117,77.7,18.0,40117,58.3,13.0
18483,9075,9408,40119,37667.0,39904.0,27481.0,25707.0,17557.0,29145.0,33802,5931,33833,4760,67635,10691,40119,62.0,42.0,40119,51.8,35.0
7994,3657,4337,40121,42576.0,43464.0,55893.0,38214.0,49167.0,40909.0,17011,4194,17701,4141,34712,8335,40121,76.3,47.0,40121,65.9,41.0
6769,3222,3547,40123,43261.0,45748.0,31639.0,36151.0,,29279.0,14501,3790,15928,3381,30429,7171,40123,73.3,33.0,40123,60.1,27.0
12288,5580,6708,40125,44688.0,46860.0,25403.0,37856.0,72981.0,34337.0,27591,5917,29672,5679,57263,11596,40125,85.4,70.0,40125,60.9,49.0
2716,1195,1521,40127,32445.0,32382.0,33750.0,29375.0,2499.0,45156.0,4053,1387,4462,1195,8515,2582,40127,65.2,11.0,40127,81.6,14.0
544,246,298,40129,50739.0,50823.0,,,,17500.0,1630,235,1652,240,3282,475,40129,,2.0,40129,,
8271,3365,4906,40131,58139.0,59876.0,55625.0,49853.0,53819.0,67961.0,38004,5648,39145,5424,77149,11072,40131,62.8,64.0,40131,49.2,49.0
5371,2334,3037,40133,36068.0,37475.0,20208.0,35587.0,22500.0,37500.0,9442,2759,10115,2725,19557,5484,40133,85.9,29.0,40133,72.4,24.0
10261,5048,5213,40135,35736.0,35609.0,19594.0,36031.0,28750.0,22958.0,15333,4912,16477,4370,31810,9282,40135,71.1,38.0,40135,70.4,37.0
6740,2876,3864,40137,43781.0,44048.0,21776.0,42379.0,47159.0,36696.0,18163,3303,19398,3340,37561,6643,40137,69.2,42.0,40137,54.4,33.0
2733,1158,1575,40139,50242.0,51486.0,,68864.0,96406.0,43152.0,8757,2504,8372,1825,17129,4329,40139,51.3,9.0,40139,39.9,7.0
1750,848,902,40141,37759.0,40458.0,29625.0,42625.0,49250.0,27375.0,2957,668,3127,598,6084,1266,40141,59.7,6.0,40141,35.7,4.0
96498,42178,54320,40143,49759.0,54305.0,27294.0,45838.0,52177.0,39517.0,247089,54017,268472,48606,515561,102623,40143,67.1,421.0,40143,52.6,328.0
8150,3605,4545,40145,55715.0,56989.0,41157.0,51250.0,68281.0,58438.0,31523,5502,33066,4991,64589,10493,40145,68.8,56.0,40145,55.3,43.0
7307,3205,4102,40147,50023.0,51193.0,26719.0,36042.0,81951.0,40602.0,20860,3976,22595,3927,43455,7903,40147,78.6,56.0,40147,58.7,42.0
1725,666,1059,40149,49632.0,50265.0,,37321.0,,30707.0,5025,707,5024,670,10049,1377,40149,52.9,8.0,40149,51.3,8.0
1283,662,621,40151,55315.0,55833.0,23060.0,60278.0,,60000.0,3677,585,3657,402,7334,987,40151,55.5,6.0,40151,45.1,5.0
2595,1056,1539,40153,55300.0,55599.0,,53295.0,,45139.0,9307,902,8779,978,18086,1880,40153,41.0,10.0,40153,37.1,9.0
2353,1144,1209,41001,41098.0,41516.0,,,35893.0,29750.0,6847,845,6962,883,13809,1728,41001,65.0,18.0,41001,50.4,14.0
18139,9502,8637,41003,49802.0,52242.0,,58594.0,27778.0,36213.0,39465,3980,39520,3280,78985,7260,41003,48.9,43.0,41003,39.2,35.0
36894,16509,20385,41005,65965.0,66332.0,51855.0,35240.0,76919.0,48272.0,171023,19794,179518,17540,350541,37334,41005,55.2,245.0,41005,43.2,189.0
5791,2590,3201,41007,46408.0,47513.0,,36375.0,66094.0,36473.0,15177,2761,16376,2292,31553,5053,41007,72.4,37.0,41007,52.2,27.0
6638,3004,3634,41009,53179.0,53387.0,50583.0,43304.0,67128.0,27097.0,21777,2706,22015,2569,43792,5275,41009,63.2,38.0,41009,54.4,32.0
11310,5154,6156,41011,38605.0,39176.0,9214.0,27623.0,61513.0,35583.0,25506,4579,27783,3960,53289,8539,41011,73.5,78.0,41011,64.2,69.0
4048,1787,2261,41013,37106.0,37435.0,,51016.0,,54474.0,9015,1309,9178,1372,18193,2681,41013,54.0,19.0,41013,41.6,14.0
3682,1519,2163,41015,40884.0,41211.0,,,50132.0,56150.0,9356,1432,10131,1275,19487,2707,41015,61.9,29.0,41015,50.8,24.0
24220,11509,12711,41017,51223.0,51897.0,19416.0,32684.0,43006.0,37656.0,69387,12338,72618,11600,142005,23938,41017,53.1,105.0,41017,37.7,74.0
20377,8874,11503,41019,41312.0,41529.0,,23500.0,103229.0,30586.0,45725,6764,48143,5915,93868,12679,41019,67.0,118.0,41019,59.7,107.0
186,81,105,41021,44293.0,45404.0,,,,38571.0,754,177,787,152,1541,329,41021,,2.0,41021,,
1138,508,630,41023,38046.0,38680.0,,17063.0,,,3005,487,3207,443,6212,930,41023,41.9,6.0,41023,29.8,4.0
1268,573,695,41025,37580.0,37775.0,46875.0,31607.0,,,3115,433,3168,407,6283,840,41025,43.9,5.0,41025,43.3,5.0
3223,1435,1788,41027,55827.0,57009.0,,,,53247.0,9311,1994,9671,1692,18982,3686,41027,45.6,11.0,41027,40.9,10.0
39122,18447,20675,41029,44028.0,44599.0,33798.0,22617.0,51042.0,35653.0,84534,16280,92282,14188,176816,30468,41029,62.6,184.0,41029,45.6,134.0
4358,2092,2266,41031,46366.0,48903.0,33375.0,42043.0,,36888.0,8583,2016,8962,1739,17545,3755,41031,50.9,14.0,41031,43.2,11.0
16627,8447,8180,41033,37665.0,37988.0,43750.0,60074.0,,34104.0,34548,5828,37702,4663,72250,10491,41033,72.1,104.0,41033,56.9,83.0
12542,5452,7090,41035,40336.0,41083.0,14682.0,25313.0,105227.0,37708.0,28026,4452,28850,4124,56876,8576,41035,60.3,56.0,41035,47.7,44.0
1365,663,702,41037,32369.0,33559.0,,19276.0,,29018.0,3203,540,3147,471,6350,1011,41037,47.0,6.0,41037,33.3,4.0
70308,34709,35599,41039,44103.0,45046.0,28998.0,38869.0,32816.0,37962.0,150317,24192,161782,19249,312099,43441,41039,53.9,237.0,41039,45.3,200.0
7754,3580,4174,41041,42101.0,42464.0,,33036.0,31875.0,40511.0,18568,3765,20081,3652,38649,7417,41041,74.4,60.0,41041,58.9,47.0
22201,9995,12206,41043,45644.0,45963.0,,23125.0,72702.0,30333.0,50776,7628,53255,6574,104031,14202,41043,71.3,106.0,41043,53.4,79.0
6865,2879,3986,41045,35418.0,35547.0,,55833.0,40333.0,31447.0,11227,2206,11663,2105,22890,4311,41045,54.0,20.0,41045,41.5,15.0
57846,26573,31273,41047,48432.0,50425.0,28841.0,33357.0,45974.0,39243.0,131443,24315,141525,20041,272968,44356,41047,66.1,227.0,41047,45.9,157.0
1844,862,982,41049,50918.0,51045.0,,,,46196.0,5057,741,4632,766,9689,1507,41049,62.3,8.0,41049,53.5,7.0
136472,64213,72259,41051,54102.0,57449.0,27045.0,32500.0,52622.0,39321.0,323119,53210,345432,41447,668551,94657,41051,62.2,432.0,41051,47.5,327.0
12270,5616,6654,41053,52821.0,54652.0,,32212.0,35682.0,51414.0,32708,4268,36242,3666,68950,7934,41053,52.1,48.0,41053,38.3,36.0
386,170,216,41055,38362.0,38879.0,,,,,704,199,766,126,1470,325,41055,,2.0,41055,,
4310,2086,2224,41057,42581.0,42794.0,,,79457.0,29500.0,10705,1559,10946,1557,21651,3116,41057,63.6,27.0,41057,44.0,19.0
12733,5516,7217,41059,48101.0,49732.0,,30594.0,75595.0,42763.0,30466,5561,31784,4760,62250,10321,41059,58.0,48.0,41059,45.1,37.0
4641,1955,2686,41061,43822.0,44375.0,,54063.0,,33466.0,10846,1648,11547,1416,22393,3064,41061,44.7,15.0,41061,41.7,15.0
1033,492,541,41063,40581.0,40625.0,19375.0,,,40750.0,2903,428,3121,311,6024,739,41063,46.3,6.0,41063,35.5,4.0
4015,1812,2203,41065,43422.0,43695.0,,52031.0,39886.0,41149.0,10397,1964,11059,1641,21456,3605,41065,74.1,26.0,41065,51.7,18.0
64861,29554,35307,41067,66754.0,67279.0,61752.0,51701.0,85141.0,44554.0,238347,34065,251792,28520,490139,62585,41067,48.0,231.0,41067,35.1,167.0
250,107,143,41069,33487.0,33750.0,,,,59063.0,609,40,614,76,1223,116,41069,,2.0,41069,,
15877,7131,8746,41071,53423.0,55047.0,35625.0,24688.0,42619.0,42816.0,42081,6619,45550,4735,87631,11354,41071,65.2,73.0,41071,44.7,50.0
8715,3721,4994,42001,60356.0,61388.0,32255.0,,43333.0,33977.0,45267,4419,46924,3839,92191,8258,42001,59.2,79.0,42001,41.5,55.0
155874,67353,88521,42003,53040.0,57898.0,27238.0,31098.0,61044.0,43257.0,536490,48058,596998,35491,1133488,83549,42003,72.5,1193.0,42003,51.3,862.0
8738,3962,4776,42005,44942.0,44992.0,40000.0,48125.0,,44107.0,30637,2828,31315,2661,61952,5489,42005,66.4,67.0,42005,46.4,48.0
19888,8582,11306,42007,50581.0,52350.0,28447.0,,53750.0,51067.0,75565,5976,81562,5378,157127,11354,42007,76.5,192.0,42007,49.7,129.0
6643,2986,3657,42009,45930.0,46059.0,,45547.0,51103.0,37431.0,21515,2699,21871,2457,43386,5156,42009,51.0,37.0,42009,41.2,30.0
56855,25575,31280,42011,55936.0,59459.0,31141.0,35042.0,71438.0,27558.0,179872,20953,191095,17231,370967,38184,42011,64.1,316.0,42011,42.3,211.0
18548,8198,10350,42013,43981.0,44283.0,30833.0,,73409.0,51420.0,55111,5728,59618,4406,114729,10134,42013,66.3,119.0,42013,43.9,79.0
8336,3681,4655,42015,48987.0,48742.0,,,37679.0,56111.0,26927,3428,28330,2923,55257,6351,42015,70.7,63.0,42015,50.2,45.0
36868,15318,21550,42017,77568.0,78570.0,46945.0,76107.0,108482.0,56197.0,283543,20263,300110,16531,583653,36794,42017,62.5,487.0,42017,43.9,340.0
16325,7113,9212,42019,60934.0,60823.0,47697.0,,110260.0,55694.0,84451,5945,88136,5118,172587,11063,42019,61.4,143.0,42019,48.9,114.0
20011,8513,11498,42021,42107.0,43150.0,14837.0,,,32171.0,59888,5256,65635,4046,125523,9302,42021,56.7,119.0,42021,43.7,95.0
626,217,409,42023,39897.0,39880.0,,,,,2224,193,2302,105,4526,298,42023,60.6,5.0,42023,,
6909,2993,3916,42025,49973.0,50489.0,34761.0,,,41250.0,28504,2939,29761,2620,58265,5559,42025,72.7,68.0,42025,53.4,50.0
27217,14043,13174,42027,52186.0,54551.0,33065.0,15278.0,29250.0,34652.0,73881,5854,70268,4384,144149,10238,42027,53.1,77.0,42027,37.9,56.0
35053,15855,19198,42029,85976.0,87386.0,48570.0,98106.0,127414.0,51662.0,226928,20920,240899,16180,467827,37100,42029,54.0,301.0,42029,39.4,219.0
6881,3045,3836,42031,42536.0,43024.0,22989.0,,,,16960,2041,18309,1721,35269,3762,42031,59.2,31.0,42031,45.1,23.0
11306,5035,6271,42033,42257.0,42138.0,61122.0,60208.0,,,33960,3682,35154,3195,69114,6877,42033,60.3,69.0,42033,45.6,53.0
6086,2474,3612,42035,45078.0,45425.0,,41250.0,,,16748,2119,18306,1834,35054,3953,42035,67.7,34.0,42035,57.3,29.0
10067,4475,5592,42037,45374.0,46253.0,30915.0,14875.0,30163.0,43893.0,29360,2388,32437,1957,61797,4345,42037,58.0,50.0,42037,43.7,38.0
12321,5698,6623,42039,44579.0,45278.0,21106.0,16731.0,21944.0,26471.0,36696,5586,38231,5244,74927,10830,42039,67.5,81.0,42039,54.0,64.0
19984,8850,11134,42041,61820.0,62265.0,36677.0,,77500.0,41218.0,105040,9174,113648,7226,218688,16400,42041,56.8,172.0,42041,40.0,123.0
36269,16243,20026,42043,53754.0,59990.0,36515.0,34125.0,57106.0,33802.0,115148,13772,127773,11033,242921,24805,42043,66.7,210.0,42043,45.1,144.0
57202,25013,32189,42045,65123.0,74867.0,40613.0,44766.0,71357.0,38914.0,241202,23418,269945,19730,511147,43148,42045,70.8,468.0,42045,52.7,350.0
2721,1090,1631,42047,46671.0,46601.0,,,,100365.0,14208,1204,14844,791,29052,1995,42047,65.8,32.0,42047,54.2,27.0
44595,19834,24761,42049,45971.0,48290.0,24473.0,25658.0,31455.0,19381.0,121595,12453,131087,9475,252682,21928,42049,66.5,225.0,42049,48.7,164.0
25282,10838,14444,42051,39636.0,40678.0,20456.0,,48326.0,27262.0,57134,6460,62630,5263,119764,11723,42051,77.5,151.0,42051,59.9,119.0
523,245,278,42053,35533.0,35321.0,,,135208.0,33333.0,1618,95,1800,156,3418,251,42053,68.6,8.0,42053,68.0,8.0
17554,7644,9910,42055,53916.0,55109.0,30214.0,28688.0,57560.0,38934.0,63891,10065,68419,8597,132310,18662,42055,58.5,116.0,42055,44.8,89.0
1779,763,1016,42057,48311.0,49088.0,21250.0,,,28250.0,6665,725,6698,562,13363,1287,42057,54.3,11.0,42057,49.1,10.0
4672,1970,2702,42059,46661.0,47138.0,35000.0,,,,14997,1423,16705,1409,31702,2832,42059,84.2,42.0,42059,60.0,29.0
5578,2342,3236,42061,44396.0,44471.0,,,31250.0,37188.0,18556,2031,19914,1550,38470,3581,42061,58.4,36.0,42061,45.7,29.0
14176,6724,7452,42063,45195.0,45305.0,40556.0,,,36250.0,37802,5238,38940,4362,76742,9600,42063,52.9,59.0,42063,36.8,42.0
6414,2841,3573,42065,42903.0,43147.0,,,53750.0,30833.0,19527,2451,19928,2305,39455,4756,42065,66.1,43.0,42065,41.4,27.0
3245,1410,1835,42067,47398.0,47564.0,,,2499.0,41184.0,10386,1917,10615,1643,21001,3560,42067,54.7,18.0,42067,43.0,14.0
30447,13104,17343,42069,46271.0,46849.0,31192.0,31625.0,45169.0,26552.0,91401,9669,101629,6991,193030,16660,42069,70.4,208.0,42069,47.5,144.0
55372,25250,30122,42071,57721.0,59790.0,33793.0,43304.0,70479.0,32206.0,221257,34798,235699,31456,456956,66254,42071,53.3,340.0,42071,38.5,249.0
13192,5770,7422,42073,44571.0,45877.0,18028.0,,98750.0,40515.0,38993,3672,41997,3459,80990,7131,42073,71.3,95.0,42073,52.1,71.0
14922,6555,8367,42075,55499.0,57224.0,36766.0,112566.0,72616.0,35560.0,57116,8512,61657,6814,118773,15326,42075,65.3,120.0,42075,49.8,92.0
45488,19230,26258,42077,56117.0,58751.0,34913.0,49444.0,91266.0,35773.0,151765,19454,165135,15567,316900,35021,42077,63.6,271.0,42077,41.0,178.0
48822,21579,27243,42079,45897.0,47331.0,21658.0,13047.0,64508.0,29652.0,137597,14632,148186,11958,285783,26590,42079,68.7,308.0,42079,46.1,210.0
16150,7164,8986,42081,47313.0,48604.0,26579.0,,82188.0,26250.0,51054,5422,52534,4512,103588,9934,42081,67.1,101.0,42081,51.0,78.0
6830,3230,3600,42083,43965.0,44175.0,,,,32353.0,18718,1718,18801,1542,37519,3260,42083,68.1,39.0,42083,50.2,30.0
14549,6345,8204,42085,44156.0,45735.0,25910.0,,67000.0,29262.0,48461,5240,53276,4406,101737,9646,42085,66.9,110.0,42085,50.6,86.0
7216,3249,3967,42087,41288.0,41371.0,,,,,19174,3604,20046,3293,39220,6897,42087,70.4,48.0,42087,52.0,36.0
20702,9712,10990,42089,57365.0,57031.0,59221.0,61563.0,80575.0,56912.0,71747,10430,76082,8624,147829,19054,42089,72.5,139.0,42089,55.0,103.0
52330,22642,29688,42091,80675.0,83652.0,53994.0,64286.0,87743.0,56152.0,361453,25180,392043,20908,753496,46088,42091,56.8,569.0,42091,40.4,408.0
1749,722,1027,42093,54648.0,53397.0,,,80375.0,,7936,723,8717,523,16653,1246,42093,56.1,15.0,42093,32.0,8.0
27294,11982,15312,42095,60972.0,62375.0,44719.0,29604.0,80378.0,40092.0,132436,12987,141524,9699,273960,22686,42095,64.7,249.0,42095,45.5,177.0
12279,5998,6281,42097,42406.0,42540.0,25121.0,,73050.0,31435.0,39185,4548,41667,4065,80852,8613,42097,66.3,91.0,42097,52.4,73.0
4217,1783,2434,42099,57177.0,57520.0,27292.0,49000.0,,45455.0,19945,2762,20190,2275,40135,5037,42099,71.8,41.0,42099,54.1,30.0
399352,178789,220563,42101,38253.0,50895.0,30180.0,25885.0,39091.0,27945.0,612194,114397,726984,87190,1339178,201587,42101,81.5,1260.0,42101,58.3,903.0
5532,2403,3129,42103,60180.0,59775.0,69395.0,,120227.0,56642.0,25086,2848,25903,2381,50989,5229,42103,64.5,52.0,42103,41.2,32.0
2570,1124,1446,42105,40654.0,40687.0,37500.0,41389.0,,26250.0,7682,900,7666,898,15348,1798,42105,79.8,22.0,42105,56.6,15.0
18278,8099,10179,42107,45535.0,45908.0,24259.0,8954.0,54432.0,33705.0,61870,6938,64964,5868,126834,12806,42107,68.1,144.0,42107,52.8,114.0
4077,1683,2394,42109,49917.0,50203.0,,,,31563.0,16547,3112,17299,2766,33846,5878,42109,50.4,25.0,42109,38.2,19.0
9074,3689,5385,42111,44587.0,44718.0,,53594.0,,37083.0,32134,3445,33368,2942,65502,6387,42111,48.5,56.0,42111,37.1,43.0
802,459,343,42113,44189.0,44342.0,,,,17050.0,2854,366,2758,213,5612,579,42113,69.3,8.0,42113,45.9,6.0
5455,2517,2938,42115,50477.0,50628.0,60568.0,,,38935.0,18579,2615,18736,2134,37315,4749,42115,53.6,35.0,42115,43.2,27.0
5891,2553,3338,42117,46494.0,46561.0,40833.0,,,53438.0,18480,2352,18945,2094,37425,4446,42117,69.6,41.0,42117,44.5,27.0
4554,1984,2570,42119,49803.0,49615.0,,,53750.0,48236.0,17003,2494,17874,2024,34877,4518,42119,57.6,30.0,42119,36.8,20.0
8123,3615,4508,42121,43644.0,44128.0,22917.0,28500.0,30357.0,,23455,2613,25029,2049,48484,4662,42121,74.7,60.0,42121,56.5,46.0
4891,2209,2682,42123,44020.0,44145.0,,18750.0,158472.0,40833.0,18265,1861,18589,1539,36854,3400,42123,59.9,38.0,42123,48.3,31.0
21074,9161,11913,42125,56450.0,56965.0,28359.0,9444.0,112118.0,56910.0,93215,7837,99622,5900,192837,13737,42125,68.2,201.0,42125,51.8,156.0
6164,2836,3328,42127,49919.0,49665.0,70000.0,,139063.0,37174.0,21793,2342,22210,1717,44003,4059,42127,64.4,51.0,42127,48.3,39.0
36758,15792,20966,42129,52247.0,52821.0,26907.0,40875.0,80903.0,33179.0,161502,12108,173372,9949,334874,22057,42129,70.5,387.0,42129,48.5,271.0
3030,1313,1717,42131,51004.0,51191.0,,,,42000.0,12674,1311,12815,1103,25489,2414,42131,77.1,29.0,42131,51.5,20.0
46124,19823,26301,42133,58269.0,60022.0,40535.0,48542.0,64840.0,31611.0,193984,20254,205039,15547,399023,35801,42133,67.2,353.0,42133,46.0,240.0
3396,1458,1938,44001,72458.0,72815.0,,,75000.0,63583.0,21668,1527,23909,1403,45577,2930,44001,54.5,37.0,44001,38.8,27.0
13763,5821,7942,44003,64383.0,65089.0,46339.0,30882.0,72306.0,49607.0,73271,5936,79937,4404,153208,10340,44003,68.9,150.0,44003,52.6,116.0
8005,3159,4846,44005,69526.0,72063.0,35324.0,7721.0,64632.0,36956.0,34929,3532,38696,2747,73625,6279,44005,60.1,70.0,44005,42.2,50.0
107120,47085,60035,44007,49743.0,54148.0,35635.0,25581.0,52668.0,29084.0,259880,39761,291105,29863,550985,69624,44007,72.7,503.0,44007,50.8,356.0
11939,5494,6445,44009,72807.0,74124.0,69850.0,29375.0,34773.0,55031.0,56838,3949,61538,3037,118376,6986,44009,64.8,104.0,44009,45.9,74.0
5471,2510,2961,45001,34799.0,39503.0,21304.0,,,49389.0,10557,1616,11107,1521,21664,3137,45001,68.1,24.0,45001,57.6,20.0
29126,13078,16048,45003,45759.0,52351.0,31960.0,28438.0,49821.0,29596.0,66457,11763,73660,10259,140117,22022,45003,58.5,122.0,45003,44.0,91.0
2537,1164,1373,45005,25327.0,41034.0,22265.0,,,38583.0,3288,870,3874,725,7162,1595,45005,61.7,8.0,45005,50.1,6.0
30915,13201,17714,45007,42143.0,45829.0,27256.0,,34816.0,40913.0,77981,13678,84828,13434,162809,27112,45007,69.6,166.0,45007,52.5,124.0
4077,2090,1987,45009,31314.0,45490.0,22015.0,,,,5833,1422,6560,1456,12393,2878,45009,59.0,13.0,45009,54.5,11.0
5819,2287,3532,45011,34336.0,44746.0,22500.0,30962.0,,,8393,1764,10059,1590,18452,3354,45011,59.5,15.0,45011,56.2,15.0
21221,9021,12200,45013,57048.0,65213.0,31229.0,37011.0,50397.0,42350.0,65203,13044,74251,11394,139454,24438,45013,49.0,124.0,45013,39.0,96.0
26327,11742,14585,45015,52506.0,59883.0,37471.0,23250.0,60368.0,42668.0,76790,14687,82601,13959,159391,28646,45015,84.8,142.0,45015,59.7,97.0
2896,1389,1507,45017,43531.0,53496.0,30412.0,,,,5943,1245,6540,1110,12483,2355,45017,59.7,12.0,45017,40.0,8.0
62119,26269,35850,45019,53437.0,66565.0,29012.0,25000.0,57008.0,38053.0,147518,27588,165993,24784,313511,52372,45019,65.5,257.0,45019,45.7,177.0
13093,5591,7502,45021,35389.0,40232.0,23805.0,11472.0,13571.0,34590.0,22852,4085,24214,4363,47066,8448,45021,87.7,56.0,45021,57.9,38.0
8734,3931,4803,45023,31914.0,40675.0,22845.0,92000.0,,36307.0,13333,2418,14555,2043,27888,4461,45023,77.4,32.0,45023,61.8,25.0
11930,6027,5903,45025,32083.0,36565.0,24898.0,63750.0,95439.0,31630.0,18061,4230,20021,3415,38082,7645,45025,81.2,45.0,45025,69.2,37.0
8163,3623,4540,45027,33162.0,47509.0,21927.0,,,30735.0,12476,2754,14807,2550,27283,5304,45027,70.0,35.0,45027,55.4,27.0
8340,3466,4874,45029,32804.0,39830.0,25033.0,,,32708.0,13977,3684,16615,3138,30592,6822,45029,93.5,48.0,45029,73.9,38.0
15878,6580,9298,45031,35409.0,45652.0,24959.0,,69000.0,37014.0,26494,5130,30063,5479,56557,10609,45031,72.4,62.0,45031,56.2,49.0
10502,4356,6146,45033,28938.0,33514.0,24378.0,14494.0,,31146.0,11823,2818,13869,2550,25692,5368,45033,85.5,32.0,45033,73.6,27.0
18737,7557,11180,45035,54901.0,61613.0,36841.0,33068.0,65929.0,36221.0,58873,9427,65555,8997,124428,18424,45035,70.6,89.0,45035,50.5,61.0
3896,1597,2299,45037,46637.0,58766.0,29944.0,,,,10071,1561,10803,1356,20874,2917,45037,58.5,18.0,45037,40.1,11.0
5566,2255,3311,45039,36004.0,46349.0,29073.0,,,37724.0,8822,2045,10276,1634,19098,3679,45039,57.9,18.0,45039,50.7,16.0
26802,11243,15559,45041,42080.0,51691.0,31343.0,,68587.0,40078.0,54653,9130,64203,8756,118856,17886,45041,72.8,115.0,45041,56.3,87.0
12557,5083,7474,45043,42835.0,55095.0,23386.0,,,24022.0,23043,5322,25907,5666,48950,10988,45043,59.2,57.0,45043,54.4,51.0
72169,31335,40834,45045,50540.0,55728.0,30967.0,35703.0,63886.0,32197.0,191418,36038,210433,32540,401851,68578,45045,64.6,324.0,45045,48.8,241.0
15875,6825,9050,45047,37060.0,46363.0,22744.0,,,26611.0,26455,5937,30943,5161,57398,11098,45047,63.2,54.0,45047,50.4,43.0
3963,1734,2229,45049,31410.0,44739.0,25693.0,133021.0,,61324.0,7981,1277,8585,1251,16566,2528,45049,78.1,20.0,45049,54.2,14.0
51988,23286,28702,45051,43299.0,45997.0,27800.0,46285.0,38530.0,32182.0,110502,30159,122928,25877,233430,56036,45051,74.7,286.0,45051,58.5,219.0
6106,2888,3218,45053,37141.0,44091.0,27690.0,,36422.0,39732.0,9645,3107,10827,2293,20472,5400,45053,51.9,14.0,45053,41.3,11.0
10467,4672,5795,45055,43622.0,51569.0,27098.0,,,52782.0,25576,4545,27680,4370,53256,8915,45055,73.6,57.0,45055,58.6,46.0
14802,6340,8462,45057,44016.0,49124.0,28505.0,,68304.0,51886.0,31574,6691,35660,5498,67234,12189,45057,67.5,68.0,45057,52.1,51.0
13395,5938,7457,45059,38515.0,41073.0,31427.0,,,31319.0,26436,5237,28520,5001,54956,10238,45059,80.2,67.0,45059,61.6,52.0
4663,2202,2461,45061,30954.0,45322.0,23019.0,,,,6869,1249,7676,1059,14545,2308,45061,73.0,17.0,45061,63.0,14.0
38470,16614,21856,45063,53857.0,56968.0,38020.0,40893.0,64959.0,40926.0,113462,18221,123168,15916,236630,34137,45063,68.5,196.0,45063,49.4,139.0
1681,741,940,45065,38712.0,52933.0,27585.0,,,,3739,490,4037,355,7776,845,45065,67.4,13.0,45065,41.8,8.0
8865,3480,5385,45067,29874.0,46372.0,21887.0,46161.0,85345.0,67938.0,11895,2774,14719,2576,26614,5350,45067,79.3,33.0,45067,62.1,25.0
7224,3108,4116,45069,30767.0,36947.0,26417.0,17969.0,37917.0,28689.0,9909,2000,11330,1652,21239,3652,45069,87.2,29.0,45069,70.7,23.0
6436,2717,3719,45071,40127.0,49982.0,27778.0,,83631.0,27612.0,15554,2451,17302,1876,32856,4327,45071,58.5,29.0,45071,52.9,26.0
14897,6520,8377,45073,41237.0,42444.0,32692.0,52813.0,49615.0,30482.0,30610,5988,32900,4886,63510,10874,45073,68.8,75.0,45073,55.1,59.0
20600,9050,11550,45075,34218.0,42791.0,28803.0,23516.0,53864.0,28301.0,33986,8236,40299,7329,74285,15565,45075,63.3,71.0,45075,48.0,54.0
22545,10766,11779,45077,41459.0,42360.0,31948.0,40037.0,31250.0,34596.0,51713,7705,52787,7184,104500,14889,45077,74.0,99.0,45077,51.5,69.0
62611,26738,35873,45079,49131.0,61259.0,37214.0,34968.0,53458.0,45717.0,151728,23127,176936,21861,328664,44988,45079,70.1,242.0,45079,49.3,167.0
4062,1813,2249,45081,38827.0,48736.0,24643.0,2499.0,,30647.0,7809,2323,8061,1629,15870,3952,45081,55.1,14.0,45081,49.6,13.0
49665,21832,27833,45083,43907.0,48916.0,30228.0,35163.0,56763.0,40947.0,116394,21970,128890,19821,245284,41791,45083,73.1,241.0,45083,55.0,179.0
18943,8146,10797,45085,41332.0,50229.0,30599.0,43485.0,45332.0,42980.0,41053,7699,47931,7265,88984,14964,45085,72.0,84.0,45085,49.0,57.0
5605,2257,3348,45087,34033.0,41221.0,21953.0,,,28250.0,11273,1890,12828,1661,24101,3551,45087,94.2,36.0,45087,67.7,26.0
9349,3950,5399,45089,28297.0,44696.0,22760.0,,2499.0,,11827,2608,14320,2656,26147,5264,45089,66.3,29.0,45089,59.4,26.0
31814,13652,18162,45091,54117.0,61048.0,32553.0,33452.0,70469.0,50644.0,100411,14632,109930,13654,210341,28286,45091,66.8,157.0,45091,54.0,124.0
223,105,118,46003,48750.0,49811.0,,,,45521.0,1228,120,1171,92,2399,212,46003,96.0,4.0,46003,,
3708,1647,2061,46005,46267.0,46903.0,,,25938.0,26238.0,8284,702,7876,999,16160,1701,46005,48.6,12.0,46005,30.7,8.0
1361,631,730,46007,42171.0,48589.0,30938.0,33836.0,,,1209,437,1419,333,2628,770,46007,,2.0,46007,,
576,268,308,46009,45254.0,45572.0,,,,25208.0,2563,127,2707,185,5270,312,46009,55.7,6.0,46009,50.4,5.0
4811,2411,2400,46011,50082.0,50600.0,48246.0,22885.0,45521.0,32049.0,15337,1441,14945,1191,30282,2632,46011,53.5,14.0,46011,37.9,10.0
3613,1635,1978,46013,53100.0,53486.0,,37424.0,,41821.0,16936,1375,17705,1494,34641,2869,46013,57.5,27.0,46013,44.8,22.0
789,351,438,46015,49531.0,50734.0,,38750.0,,,2230,329,2358,273,4588,602,46015,83.0,6.0,46015,53.7,4.0
711,362,349,46017,31163.0,49250.0,,27500.0,,,498,529,542,469,1040,998,46017,,2.0,46017,,
1082,514,568,46019,41920.0,43065.0,,13862.0,,24688.0,4029,966,4329,836,8358,1802,46019,60.8,9.0,46019,59.5,8.0
140,58,82,46021,45170.0,45909.0,,,,,702,29,757,60,1459,89,46021,,2.0,46021,,
1970,923,1047,46023,43109.0,50458.0,,25208.0,,37250.0,3578,909,3650,869,7228,1778,46023,48.9,6.0,46023,34.5,4.0
566,285,281,46025,49600.0,49550.0,,,,56146.0,1657,175,1603,126,3260,301,46025,,2.0,46025,,
3255,1660,1595,46027,36608.0,38561.0,,,,16493.0,6070,851,6226,656,12296,1507,46027,61.4,7.0,46027,51.0,6.0
2806,1298,1508,46029,48912.0,49812.0,,50625.0,,40556.0,12669,1152,12462,1165,25131,2317,46029,49.4,16.0,46029,45.2,15.0
1865,907,958,46031,31676.0,48661.0,,19266.0,,,1558,565,1619,407,3177,972,46031,,2.0,46031,,
850,373,477,46033,52218.0,53153.0,,39412.0,,2499.0,3586,437,3623,442,7209,879,46033,38.6,6.0,46033,32.9,5.0
2379,1314,1065,46035,49991.0,50733.0,,,,78784.0,8778,1039,9135,456,17913,1495,46035,64.2,17.0,46035,48.3,13.0
1200,559,641,46037,39216.0,40633.0,,21500.0,,,2426,334,2393,305,4819,639,46037,45.0,4.0,46037,43.6,5.0
330,160,170,46039,53152.0,52989.0,,,,73100.0,2086,138,1909,140,3995,278,46039,48.0,3.0,46039,46.8,3.0
1523,728,795,46041,37206.0,58875.0,,30184.0,,,1728,959,1860,987,3588,1946,46041,82.2,3.0,46041,,
246,72,174,46043,52500.0,52594.0,,,,,1168,245,1283,181,2451,426,46043,81.9,4.0,46043,,
479,213,266,46045,56000.0,55000.0,,,,,1770,142,1888,97,3658,239,46045,,2.0,46045,,
1097,543,554,46047,45997.0,46376.0,,,,46389.0,2999,348,3005,351,6004,699,46047,63.6,8.0,46047,55.0,7.0
373,244,129,46049,43679.0,43679.0,,,,,1135,88,1011,70,2146,158,46049,,2.0,46049,,
582,228,354,46051,51272.0,51629.0,,,,33859.0,3334,406,3284,156,6618,562,46051,55.1,6.0,46051,33.3,3.0
769,363,406,46053,37540.0,39345.0,,17500.0,,,1909,213,1848,206,3757,419,46053,75.8,5.0,46053,57.3,4.0
343,181,162,46055,41518.0,41756.0,,,,,938,104,924,78,1862,182,46055,,2.0,46055,,
424,176,248,46057,58602.0,58729.0,,,,53750.0,2741,245,2698,157,5439,402,46057,47.8,3.0,46057,,
271,138,133,46059,47163.0,46971.0,,,,,1529,163,1557,71,3086,234,46059,,2.0,46059,,
406,245,161,46061,60741.0,61157.0,,,,,1601,123,1553,106,3154,229,46061,,2.0,46061,,
174,85,89,46063,52396.0,52569.0,,,,,612,57,586,50,1198,107,46063,,2.0,46063,,
1663,776,887,46065,59177.0,63888.0,,22260.0,,46458.0,7561,789,7576,567,15137,1356,46065,52.1,10.0,46065,30.7,6.0
926,498,428,46067,45075.0,45869.0,,,,,3235,294,3261,193,6496,487,46067,41.9,5.0,46067,31.8,4.0
168,74,94,46069,51776.0,50000.0,,74643.0,,,644,56,600,76,1244,132,46069,,2.0,46069,,
1059,511,548,46071,45074.0,50667.0,,36477.0,,,1213,368,1242,371,2455,739,46071,,2.0,46071,,
176,67,109,46073,53125.0,54034.0,,,,21875.0,877,76,983,54,1860,130,46073,,2.0,46073,,
89,49,40,46075,35972.0,37292.0,,,,,326,64,332,59,658,123,46075,,2.0,46075,,
505,219,286,46077,53828.0,55139.0,,,,28958.0,2374,181,2323,141,4697,322,46077,62.6,6.0,46077,45.5,4.0
1732,766,966,46079,54535.0,54401.0,,,53365.0,,5612,476,5438,410,11050,886,46079,46.0,7.0,46079,35.6,6.0
3115,1219,1896,46081,45548.0,46120.0,,20139.0,77188.0,60337.0,10268,1828,10732,1570,21000,3398,46081,47.8,15.0,46081,37.5,12.0
2158,859,1299,46083,76094.0,76087.0,32546.0,80417.0,250001.0,127700.0,23479,1225,23552,1339,47031,2564,46083,48.9,18.0,46083,33.8,12.0
775,360,415,46085,43030.0,50179.0,,31042.0,,,1540,469,1464,342,3004,811,46085,,2.0,46085,,
467,218,249,46087,56954.0,56901.0,,61083.0,,,2512,236,2556,160,5068,396,46087,86.0,7.0,46087,57.6,5.0
478,306,172,46089,36375.0,35625.0,,,,,935,208,971,61,1906,269,46089,,2.0,46089,,
701,296,405,46091,51788.0,53031.0,,31328.0,,53750.0,2212,202,1946,276,4158,478,46091,53.7,4.0,46091,48.5,3.0
2764,1272,1492,46093,52473.0,53750.0,41165.0,,,40112.0,11335,1390,10920,1420,22255,2810,46093,56.4,15.0,46093,44.9,12.0
921,437,484,46095,30938.0,43365.0,,20556.0,,26458.0,733,290,867,162,1600,452,46095,,2.0,46095,,
234,119,115,46097,44938.0,47813.0,,,,,1070,81,1019,94,2089,175,46097,88.3,4.0,46097,,
20578,9155,11423,46099,53525.0,56604.0,28677.0,22367.0,49618.0,47646.0,78600,9208,81047,7340,159647,16548,46099,65.3,110.0,46099,52.1,87.0
910,441,469,46101,52446.0,53630.0,,40357.0,53625.0,35313.0,2765,439,2955,224,5720,663,46101,44.2,4.0,46101,,
13079,5673,7406,46103,50890.0,52561.0,41284.0,19824.0,51544.0,42240.0,44048,6865,45946,6281,89994,13146,46103,66.1,78.0,46103,46.9,55.0
396,193,203,46105,39773.0,41346.0,,14318.0,,64063.0,1314,183,1308,131,2622,314,46105,,2.0,46105,,
255,141,114,46107,46081.0,46375.0,,,,,1000,78,1059,94,2059,172,46107,89.0,4.0,46107,,
2031,969,1062,46109,48614.0,55478.0,,33295.0,,,4011,1062,4127,920,8138,1982,46109,46.4,6.0,46109,34.9,5.0
238,121,117,46111,50541.0,50331.0,,,,54792.0,1130,77,1005,73,2135,150,46111,,2.0,46111,,
798,340,458,46115,48217.0,48483.0,,,,,3000,267,2865,288,5865,555,46115,48.8,5.0,46115,46.2,5.0
240,94,146,46117,56829.0,58788.0,,55231.0,,,1328,167,1350,117,2678,284,46117,,2.0,46117,,
74,36,38,46119,60417.0,62292.0,,,,,712,111,600,46,1312,157,46119,,2.0,46119,,
4471,2116,2355,46121,31128.0,47404.0,,23259.0,,23333.0,3268,1556,3624,1455,6892,3011,46121,,2.0,46121,64.7,3.0
1212,535,677,46123,37153.0,41250.0,,19766.0,,,2333,379,2383,265,4716,644,46123,42.6,4.0,46123,,
761,305,456,46125,53378.0,53497.0,,2499.0,,,3818,305,3733,289,7551,594,46125,56.2,6.0,46125,35.7,4.0
783,292,491,46127,64471.0,64358.0,,,,,6911,503,6929,379,13840,882,46127,80.2,14.0,46127,44.0,8.0
650,241,409,46129,43221.0,42697.0,,,,46375.0,2297,304,2438,278,4735,582,46129,47.0,5.0,46129,42.9,4.0
2993,1298,1695,46135,48176.0,48524.0,42440.0,,250001.0,37470.0,9303,1212,9798,833,19101,2045,46135,61.4,18.0,46135,43.5,13.0
1103,507,596,46137,35119.0,57813.0,,21920.0,,,958,433,1131,311,2089,744,46137,,2.0,46137,,
13309,5830,7479,47001,42880.0,43167.0,36528.0,,62000.0,35797.0,31601,4647,34889,3459,66490,8106,47001,71.1,75.0,47001,64.7,69.0
7727,3542,4185,47003,41984.0,44287.0,29068.0,21497.0,,26859.0,18606,3862,20181,2944,38787,6806,47003,69.4,35.0,47003,56.4,28.0
3667,1733,1934,47005,33240.0,33673.0,27969.0,,,40556.0,6716,1206,6888,1290,13604,2496,47005,104.7,26.0,47005,89.0,22.0
2697,1234,1463,47007,37013.0,37327.0,,,,51389.0,5313,1192,5129,829,10442,2021,47007,85.2,15.0,47007,57.3,10.0
17305,7389,9916,47009,48286.0,49144.0,27961.0,45078.0,43359.0,40141.0,52291,7725,57700,6300,109991,14025,47009,79.0,130.0,47009,54.2,89.0
19357,8597,10760,47011,42114.0,42756.0,30905.0,,61412.0,27274.0,41416,7723,45811,6183,87227,13906,47011,81.0,97.0,47011,56.7,67.0
9203,4004,5199,47013,32028.0,32177.0,52276.0,,,46190.0,16363,2910,18002,2375,34365,5285,47013,105.9,60.0,47013,86.8,49.0
2500,1154,1346,47015,41533.0,42016.0,37625.0,,,24500.0,5791,915,6198,715,11989,1630,47015,59.7,11.0,47015,58.8,10.0
5713,2656,3057,47017,35508.0,37429.0,21433.0,40625.0,,,11861,1745,12746,1520,24607,3265,47017,80.0,32.0,47017,61.0,25.0
13021,6094,6927,47019,33213.0,33347.0,19730.0,,40862.0,21346.0,22671,4536,24963,3704,47634,8240,47019,78.3,63.0,47019,67.2,54.0
5396,2410,2986,47021,51857.0,52743.0,35481.0,58750.0,93942.0,29750.0,16596,2798,17778,1931,34374,4729,47021,92.3,38.0,47021,80.6,32.0
3516,1579,1937,47023,40167.0,42250.0,20433.0,,,,6992,1252,7753,1251,14745,2503,47023,76.7,16.0,47023,48.5,10.0
6658,2951,3707,47025,34899.0,35281.0,18750.0,,,46500.0,13480,1832,14369,1537,27849,3369,47025,107.7,47.0,47025,84.2,36.0
1801,820,981,47027,28804.0,28832.0,,,,35982.0,3289,504,3422,472,6711,976,47027,76.1,9.0,47027,68.8,9.0
9111,4022,5089,47029,31187.0,31702.0,25234.0,,,,14340,2761,15175,2755,29515,5516,47029,96.9,50.0,47029,84.1,42.0
9818,4470,5348,47031,41590.0,42197.0,33108.0,,32955.0,28917.0,21912,3746,23965,3245,45877,6991,47031,84.4,57.0,47031,62.8,43.0
2838,1340,1498,47033,35464.0,37083.0,29693.0,,,23510.0,5490,1360,6572,965,12062,2325,47033,64.6,12.0,47033,58.2,11.0
9300,4080,5220,47035,38576.0,38580.0,145994.0,49345.0,114135.0,34327.0,23269,4419,25675,3444,48944,7863,47035,79.8,80.0,47035,62.7,65.0
116031,52503,63528,47037,48368.0,55498.0,34777.0,61156.0,59669.0,36097.0,257116,55169,294365,43931,551481,99100,47037,72.0,424.0,47037,57.1,331.0
2470,1098,1372,47039,37263.0,38495.0,23750.0,,42500.0,18243.0,4817,783,5231,628,10048,1411,47039,87.4,16.0,47039,76.1,14.0
3887,1562,2325,47041,38319.0,38146.0,43162.0,,186141.0,30918.0,7851,1534,8119,1287,15970,2821,47041,91.3,22.0,47041,71.9,17.0
8116,3460,4656,47043,44680.0,45109.0,27356.0,,,35053.0,21205,3245,22550,2955,43755,6200,47043,87.9,50.0,47043,67.1,38.0
6646,2680,3966,47045,42468.0,44143.0,35927.0,,26198.0,47611.0,16136,1960,17505,1914,33641,3874,47045,77.9,37.0,47045,65.4,30.0
5351,2427,2924,47047,54890.0,63996.0,31071.0,,76375.0,37120.0,16771,2081,17849,1678,34620,3759,47047,58.7,31.0,47047,49.4,25.0
4577,2281,2296,47049,30259.0,30228.0,,,,,7050,1592,7986,1068,15036,2660,47049,92.7,24.0,47049,83.0,21.0
6669,2889,3780,47051,42773.0,44659.0,29590.0,47105.0,,35267.0,17691,2152,18771,2174,36462,4326,47051,70.6,41.0,47051,54.4,31.0
9080,3806,5274,47053,38457.0,42263.0,26925.0,50000.0,,24688.0,19759,3175,22788,2799,42547,5974,47053,80.5,52.0,47053,62.1,40.0
4627,2011,2616,47055,41093.0,42674.0,23881.0,,,27237.0,11866,2083,13097,1514,24963,3597,47055,82.1,33.0,47055,59.9,24.0
4647,2091,2556,47057,35391.0,35695.0,,,,,9876,1399,10088,1227,19964,2626,47057,82.2,26.0,47057,73.0,23.0
13647,6146,7501,47059,35196.0,35485.0,30662.0,,35733.0,21065.0,27714,5087,30385,4211,58099,9298,47059,96.4,94.0,47059,72.2,70.0
3797,1683,2114,47061,27373.0,28244.0,,,,,5078,1516,5653,1091,10731,2607,47061,96.1,19.0,47061,81.9,16.0
13193,6285,6908,47063,37617.0,39145.0,23917.0,,,19621.0,24472,5810,27420,4556,51892,10366,47063,77.9,64.0,47063,68.7,55.0
54036,23604,30432,47065,48248.0,54164.0,28474.0,,71719.0,35496.0,143730,21800,161207,17627,304937,39427,47065,68.4,286.0,47065,49.6,206.0
1793,706,1087,47067,26898.0,27217.0,,19338.0,,,2707,442,2959,371,5666,813,47067,83.1,9.0,47067,67.7,7.0
5636,2479,3157,47069,31801.0,37567.0,25135.0,,,,9478,1499,10360,1465,19838,2964,47069,94.2,31.0,47069,64.3,21.0
5920,2494,3426,47071,35290.0,36024.0,13844.0,,,22006.0,10421,2093,11258,1736,21679,3829,47071,85.9,33.0,47071,63.6,24.0
10661,4410,6251,47073,36927.0,36938.0,49313.0,,,,23655,3800,26009,2563,49664,6363,47073,102.7,79.0,47073,74.3,57.0
4107,1758,2349,47075,34182.0,43339.0,23445.0,,,50595.0,6982,1432,8640,961,15622,2393,47075,80.4,18.0,47075,57.3,13.0
5925,2512,3413,47077,38745.0,40835.0,25357.0,,,21225.0,11764,1556,12878,1541,24642,3097,47077,93.4,32.0,47077,67.9,23.0
5862,2421,3441,47079,38234.0,39801.0,25625.0,2499.0,,22147.0,13056,2240,14504,1927,27560,4167,47079,88.4,45.0,47079,76.7,38.0
4738,2218,2520,47081,36334.0,36343.0,,,,,9243,2136,9564,1870,18807,4006,47081,91.5,27.0,47081,73.2,21.0
1860,949,911,47083,39401.0,40548.0,,,,,3525,482,3603,487,7128,969,47083,96.8,11.0,47083,80.8,10.0
2856,1312,1544,47085,41949.0,42328.0,26463.0,,,38333.0,7632,1281,8283,831,15915,2112,47085,99.2,26.0,47085,76.4,20.0
3034,1443,1591,47087,31534.0,31826.0,,,,,4755,970,4997,596,9752,1566,47087,102.8,18.0,47087,79.9,14.0
8343,3626,4717,47089,42417.0,43016.0,32691.0,,,32750.0,22099,3314,23371,2941,45470,6255,47089,68.9,49.0,47089,51.1,36.0
4123,1916,2207,47091,30763.0,30668.0,68194.0,,,21210.0,6761,1094,7420,917,14181,2011,47091,88.0,23.0,47091,64.8,17.0
69061,31168,37893,47093,48701.0,51862.0,26967.0,40850.0,64648.0,32710.0,188715,25474,205163,21468,393878,46942,47093,73.8,357.0,47093,55.9,268.0
1319,538,781,47095,30086.0,34148.0,20438.0,,,21513.0,1964,378,2389,250,4353,628,47095,96.8,9.0,47095,88.9,8.0
6532,2877,3655,47097,30281.0,36438.0,21414.0,,,,9660,1851,11096,1950,20756,3801,47097,92.9,28.0,47097,78.7,23.0
8443,3608,4835,47099,37814.0,38281.0,21068.0,11786.0,,49318.0,16920,3586,17705,3572,34625,7158,47099,78.2,43.0,47099,68.3,37.0
2292,1189,1103,47101,36621.0,36937.0,28750.0,,,,5069,822,4928,891,9997,1713,47101,116.1,19.0,47101,81.6,13.0
5517,2540,2977,47103,40389.0,42135.0,29464.0,33333.0,,24519.0,14055,2213,15084,1824,29139,4037,47103,64.3,30.0,47103,55.4,25.0
7185,3503,3682,47105,51107.0,50898.0,38438.0,,202750.0,31908.0,21340,2980,22655,2853,43995,5833,47105,69.2,58.0,47105,52.7,42.0
10220,4598,5622,47107,38535.0,38736.0,25694.0,35750.0,,19670.0,21366,3828,23727,2762,45093,6590,47107,81.4,59.0,47107,68.2,48.0
5319,2199,3120,47109,32557.0,33550.0,19276.0,33750.0,,21737.0,10633,1884,11543,1691,22176,3575,47109,89.5,33.0,47109,77.8,28.0
4218,1836,2382,47111,33509.0,34481.0,,,,,9374,1653,10107,1307,19481,2960,47111,100.4,27.0,47111,77.5,21.0
18521,7912,10609,47113,42544.0,53525.0,29804.0,,54583.0,22488.0,39539,6281,45874,5340,85413,11621,47113,70.7,78.0,47113,52.1,57.0
5350,2191,3159,47115,41348.0,42573.0,30769.0,,85000.0,,11793,1866,12648,1684,24441,3550,47115,102.9,40.0,47115,69.9,27.0
4986,2160,2826,47117,42661.0,43387.0,27470.0,,,32500.0,12891,2314,13708,1923,26599,4237,47117,91.6,33.0,47117,71.9,26.0
12667,5701,6966,47119,47692.0,51004.0,28893.0,25795.0,63750.0,31288.0,34469,5451,38701,4290,73170,9741,47119,73.5,69.0,47119,61.0,57.0
2377,906,1471,47121,34424.0,34311.0,,,,,4855,816,5065,839,9920,1655,47121,83.7,15.0,47121,74.0,12.0
8627,4032,4595,47123,35291.0,36519.0,20446.0,,,38315.0,19103,3290,19523,2866,38626,6156,47123,98.6,60.0,47123,73.4,45.0
28750,12557,16193,47125,50344.0,52365.0,41116.0,44857.0,47481.0,50748.0,70256,10425,82598,9307,152854,19732,47125,84.3,106.0,47125,61.2,75.0
668,268,400,47127,49427.0,49966.0,,,,,2754,284,2852,367,5606,651,47127,63.5,6.0,47127,35.3,3.0
4185,2019,2166,47129,39049.0,39058.0,,,,,7940,1055,8613,955,16553,2010,47129,94.3,26.0,47129,71.7,19.0
6309,2881,3428,47131,40281.0,42215.0,21946.0,,,23173.0,12513,2215,14041,1941,26554,4156,47131,72.6,31.0,47131,71.5,30.0
4668,2273,2395,47133,35287.0,35258.0,2499.0,,,16333.0,9276,1406,9830,1293,19106,2699,47133,98.2,32.0,47133,84.8,26.0
1995,865,1130,47135,31425.0,32151.0,,,,,3169,731,3164,667,6333,1398,47135,93.8,11.0,47135,77.3,9.0
808,315,493,47137,36773.0,37338.0,,,,,2078,391,2231,305,4309,696,47137,94.8,8.0,47137,65.2,6.0
3094,1481,1613,47139,38925.0,39296.0,,16477.0,,,7102,1098,7282,968,14384,2066,47139,116.0,28.0,47139,103.3,25.0
17830,8209,9621,47141,35343.0,35863.0,17974.0,9539.0,,37482.0,29982,5917,32553,4582,62535,10499,47141,71.6,62.0,47141,54.9,47.0
7664,3510,4154,47143,36146.0,36085.0,37337.0,,,28063.0,13770,2097,14544,1610,28314,3707,47143,99.0,41.0,47143,77.5,31.0
9620,4479,5141,47145,40854.0,41451.0,37143.0,,89722.0,,22459,3278,24188,2686,46647,5964,47145,88.6,72.0,47145,71.1,58.0
8005,3441,4564,47147,53151.0,55246.0,35804.0,,60363.0,39321.0,27866,4735,30884,3162,58750,7897,47147,83.2,59.0,47147,65.1,45.0
34475,15822,18653,47149,56219.0,58289.0,46315.0,,64022.0,41350.0,119135,18793,127230,15032,246365,33825,47149,68.5,144.0,47149,50.3,102.0
5903,2663,3240,47151,30246.0,30455.0,,,,,8916,1704,9606,1510,18522,3214,47151,109.2,29.0,47151,94.9,24.0
2335,979,1356,47153,45408.0,46633.0,,55652.0,,,6370,702,6438,861,12808,1563,47153,96.8,18.0,47153,86.6,16.0
14128,6136,7992,47155,42258.0,42542.0,41320.0,,41449.0,32952.0,35661,9701,38995,8383,74656,18084,47155,83.5,99.0,47155,61.8,72.0
196471,87291,109180,47157,46224.0,66517.0,32926.0,31892.0,80080.0,35102.0,362755,75492,425842,61338,788597,136830,47157,67.3,587.0,47157,53.2,457.0
3066,1307,1759,47159,43914.0,44382.0,33077.0,,,50125.0,8337,1010,8590,954,16927,1964,47159,92.7,21.0,47159,81.4,18.0
2560,1236,1324,47161,42023.0,42763.0,32150.0,,12143.0,16591.0,5719,822,5829,726,11548,1548,47161,90.8,17.0,47161,69.5,12.0
26924,12365,14559,47163,40346.0,40811.0,30756.0,40862.0,53611.0,23659.0,64972,9918,71960,8207,136932,18125,47163,75.7,174.0,47163,59.7,138.0
15644,6676,8968,47165,57382.0,58301.0,46756.0,49773.0,73810.0,37443.0,72373,9532,78051,8131,150424,17663,47165,65.9,121.0,47165,51.8,92.0
8292,3516,4776,47167,53669.0,58999.0,30694.0,131776.0,37340.0,63627.0,25881,4018,27879,2992,53760,7010,47167,94.6,60.0,47167,74.6,45.0
1345,614,731,47169,41029.0,46500.0,27917.0,,,,3132,702,3604,304,6736,1006,47169,101.4,9.0,47169,59.6,6.0
3974,1790,2184,47171,33210.0,33316.0,,,,26202.0,7447,1353,7908,1026,15355,2379,47171,89.3,25.0,47171,70.8,20.0
4036,1575,2461,47173,37351.0,37393.0,,,,36026.0,8076,1337,8249,1273,16325,2610,47173,100.7,24.0,47173,76.2,18.0
988,523,465,47175,40439.0,40659.0,,,,66406.0,2385,342,2324,444,4709,786,47175,55.8,4.0,47175,53.0,4.0
8329,3964,4365,47177,35376.0,36395.0,25577.0,7750.0,2499.0,26789.0,16252,3256,17765,2210,34017,5466,47177,84.7,42.0,47177,64.4,33.0
21842,9588,12254,47179,42817.0,43305.0,29939.0,40737.0,68229.0,36268.0,52464,7566,56336,7167,108800,14733,47179,71.6,110.0,47179,55.3,84.0
3211,1619,1592,47181,30701.0,30931.0,16167.0,,25000.0,21964.0,6169,1124,6540,956,12709,2080,47181,79.1,18.0,47181,72.6,16.0
6075,2810,3265,47183,37037.0,38636.0,20331.0,,,41548.0,14459,2122,15906,1468,30365,3590,47183,72.4,31.0,47183,61.2,26.0
5011,2341,2670,47185,34901.0,35297.0,27574.0,,,,10891,1717,11526,1711,22417,3428,47185,89.7,33.0,47185,65.7,23.0
10054,4225,5829,47187,96565.0,97939.0,66719.0,230583.0,105558.0,58581.0,91344,5695,96717,5137,188061,10832,47187,46.6,77.0,47187,36.5,60.0
12132,4886,7246,47189,61070.0,62769.0,35035.0,30893.0,78571.0,39795.0,52625,6781,56770,5281,109395,12062,47189,76.5,98.0,47189,55.3,68.0
8274,3779,4495,48001,41327.0,45789.0,23056.0,,61552.0,32139.0,18394,4247,18148,4112,36542,8359,48001,78.1,49.0,48001,70.1,44.0
2032,832,1200,48003,70423.0,71077.0,36689.0,,,68617.0,7005,1505,6326,1847,13331,3352,48003,64.3,9.0,48003,47.6,7.0
16497,7061,9436,48005,44223.0,48264.0,28914.0,19115.0,45545.0,38249.0,32551,8647,36126,8248,68677,16895,48005,76.4,74.0,48005,48.3,47.0
4509,2097,2412,48007,41690.0,41315.0,,,,41480.0,9334,2419,9949,2164,19283,4583,48007,78.1,33.0,48007,56.6,24.0
862,352,510,48009,60275.0,60714.0,,,,33750.0,3703,631,3866,508,7569,1139,48009,61.5,8.0,48009,45.9,5.0
130,49,81,48011,59737.0,58684.0,,,,157614.0,835,119,837,87,1672,206,48011,,2.0,48011,,
7619,3141,4478,48013,52192.0,52129.0,47429.0,50313.0,,45858.0,18670,4520,18867,4536,37537,9056,48013,42.4,21.0,48013,31.9,16.0
3289,1377,1912,48015,53687.0,55871.0,42550.0,,,43864.0,11830,2424,11973,2414,23803,4838,48015,48.0,18.0,48015,41.0,15.0
1319,500,819,48017,37397.0,40208.0,,,,32520.0,2577,1020,2319,1080,4896,2100,48017,,2.0,48017,,
2662,1322,1340,48019,49863.0,49651.0,,,,63478.0,8362,1913,8601,1726,16963,3639,48019,58.8,20.0,48019,42.9,15.0
10664,4867,5797,48021,54821.0,57274.0,47545.0,34185.0,79063.0,41443.0,30120,7315,30045,7386,60165,14701,48021,69.2,54.0,48021,56.6,43.0
423,143,280,48023,36373.0,39375.0,,,,16591.0,1359,397,1524,275,2883,672,48023,80.4,5.0,48023,57.6,4.0
5274,2344,2930,48025,42302.0,43706.0,33924.0,,,36743.0,9837,2439,9597,3215,19434,5654,48025,50.9,15.0,48025,33.2,9.0
48543,21926,26617,48027,50550.0,53878.0,44646.0,60205.0,47929.0,43438.0,122102,21650,138608,21336,260710,42986,48027,81.5,200.0,48027,54.1,130.0
312088,140680,171408,48029,51150.0,52931.0,42450.0,42873.0,63595.0,42721.0,708529,166188,762263,156662,1470792,322850,48029,45.1,702.0,48029,34.5,528.0
954,451,503,48031,55504.0,56639.0,,,,43767.0,4327,1037,4158,1089,8485,2126,48031,46.3,8.0,48031,28.2,5.0
10,5,5,48033,73750.0,72813.0,,,,58194.0,352,10,314,29,666,39,48033,,2.0,48033,,
2549,1144,1405,48035,44674.0,45320.0,,80341.0,20208.0,33179.0,6862,1821,7135,1805,13997,3626,48035,58.4,17.0,48035,59.2,18.0
16693,7537,9156,48037,42670.0,47666.0,26246.0,85455.0,44141.0,27699.0,34412,7917,38080,7433,72492,15350,48037,80.2,88.0,48037,58.7,63.0
35762,16016,19746,48039,69749.0,69781.0,62534.0,73750.0,111273.0,56698.0,132481,26179,136174,26559,268655,52738,48039,63.0,175.0,48039,47.6,130.0
53207,25213,27994,48041,39808.0,44680.0,27751.0,64219.0,31278.0,34924.0,85232,16282,85931,13975,171163,30257,48041,49.0,62.0,48041,37.2,47.0
1238,508,730,48043,38395.0,38462.0,,,,34568.0,3454,921,3970,808,7424,1729,48043,36.4,4.0,48043,33.4,4.0
307,156,151,48045,38603.0,39559.0,13125.0,,,25938.0,659,212,618,181,1277,393,48045,,2.0,48045,,
2726,1476,1250,48047,22741.0,22103.0,,,,22854.0,2335,1150,2526,887,4861,2037,48047,,2.0,48047,,
6581,2868,3713,48049,41962.0,42481.0,31548.0,18319.0,,36950.0,14557,3542,16086,2617,30643,6159,48049,65.2,34.0,48049,52.3,28.0
2761,1259,1502,48051,51821.0,55259.0,30909.0,,,46192.0,7037,1491,6762,1830,13799,3321,48051,73.1,18.0,48051,53.6,13.0
6989,3317,3672,48053,49732.0,50281.0,68452.0,51875.0,,33512.0,17966,3763,18362,3739,36328,7502,48053,65.3,43.0,48053,45.7,30.0
7169,3540,3629,48055,47233.0,49238.0,29816.0,46000.0,,41705.0,13968,4891,14535,4039,28503,8930,48055,65.1,26.0,48055,45.9,18.0
4136,1987,2149,48057,51078.0,50803.0,45407.0,,69318.0,40458.0,8824,1912,8892,1844,17716,3756,48057,70.0,18.0,48057,46.3,12.0
2548,1107,1441,48059,40981.0,41009.0,24500.0,,,36944.0,4976,1607,5360,1508,10336,3115,48059,80.4,16.0,48059,69.4,14.0
139768,63753,76015,48061,33266.0,33004.0,36583.0,33558.0,99196.0,30795.0,137295,62556,146719,68645,284014,131201,48061,38.4,143.0,48061,24.0,89.0
2454,1046,1408,48063,37851.0,40938.0,21661.0,,,35677.0,4688,1389,4971,1400,9659,2789,48063,74.8,12.0,48063,53.4,9.0
435,202,233,48065,66023.0,66818.0,,53611.0,,79444.0,2499,411,2655,455,5154,866,48065,44.5,4.0,48065,45.0,4.0
5915,2548,3367,48067,37352.0,41114.0,23500.0,,41014.0,,11536,2986,12405,2993,23941,5979,48067,68.9,32.0,48067,58.8,27.0
1339,672,667,48069,39459.0,40000.0,,,,30800.0,2591,1412,2678,1177,5269,2589,48069,50.7,5.0,48069,35.5,3.0
3921,1677,2244,48071,70544.0,75877.0,44962.0,9750.0,133387.0,48743.0,15184,3360,15082,3420,30266,6780,48071,68.3,21.0,48071,56.9,17.0
10688,4875,5813,48073,39595.0,42449.0,19321.0,37083.0,35114.0,34673.0,19081,5260,19740,4874,38821,10134,48073,83.3,51.0,48073,60.3,37.0
1177,573,604,48075,36633.0,38333.0,,,,,2421,470,2582,350,5003,820,48075,72.5,6.0,48075,50.5,4.0
1246,620,626,48077,48297.0,49203.0,,,,60000.0,4461,766,4233,943,8694,1709,48077,68.8,11.0,48077,55.3,9.0
591,267,324,48079,39113.0,39808.0,20938.0,,,28942.0,1002,497,1038,412,2040,909,48079,,2.0,48079,,
361,152,209,48081,42467.0,42467.0,,,,30917.0,1277,310,1282,252,2559,562,48081,52.5,3.0,48081,,
1924,720,1204,48083,35156.0,35228.0,41618.0,,,33333.0,3084,1115,3194,1106,6278,2221,48083,70.7,10.0,48083,61.8,9.0
64824,30107,34717,48085,84735.0,86517.0,64806.0,93355.0,103313.0,54558.0,364117,57505,384036,53416,748153,110921,48085,49.4,286.0,48085,36.7,207.0
675,229,446,48087,39743.0,43520.0,,18000.0,,26214.0,1119,351,1189,337,2308,688,48087,,2.0,48087,,
3081,1430,1651,48089,46618.0,49512.0,25884.0,,,36524.0,8211,1852,8609,1745,16820,3597,48089,65.6,20.0,48089,57.6,18.0
10423,4122,6301,48091,65833.0,66156.0,71536.0,114904.0,71272.0,54888.0,49481,9194,51021,8970,100502,18164,48091,58.1,83.0,48091,42.7,61.0
3107,1420,1687,48093,37470.0,38030.0,,,,32065.0,4842,1755,5054,1778,9896,3533,48093,76.4,17.0,48093,61.6,13.0
298,81,217,48095,48368.0,48485.0,,,,26827.0,1211,148,1081,245,2292,393,48095,,2.0,48095,,
5292,2322,2970,48097,52406.0,53402.0,29886.0,,,39560.0,15879,2963,16252,3158,32131,6121,48097,62.1,32.0,48097,53.7,27.0
8631,3528,5103,48099,49340.0,50512.0,49083.0,48403.0,41667.0,38850.0,23726,2768,29019,3462,52745,6230,48099,81.2,41.0,48099,58.1,28.0
340,167,173,48101,34955.0,37067.0,30179.0,,,30179.0,582,204,557,167,1139,371,48101,,2.0,48101,,
606,236,370,48103,58333.0,54083.0,,,,57868.0,1940,387,1840,469,3780,856,48103,,2.0,48103,,
635,239,396,48105,53678.0,54412.0,,,,51481.0,1499,308,1388,424,2887,732,48105,,2.0,48105,,
1358,544,814,48107,37434.0,38628.0,19464.0,,,33102.0,2246,626,2210,834,4456,1460,48107,57.0,5.0,48107,38.2,3.0
677,307,370,48109,35000.0,35302.0,,,,26111.0,881,231,916,255,1797,486,48109,,2.0,48109,,
1183,511,672,48111,41345.0,41239.0,82639.0,61750.0,63750.0,33125.0,2899,819,2415,842,5314,1661,48111,79.4,4.0,48111,,
472926,211723,261203,48113,50270.0,56527.0,37476.0,40843.0,68847.0,40562.0,887696,324950,964891,287195,1852587,612145,48113,56.0,1078.0,48113,42.8,802.0
1924,729,1195,48115,41095.0,43706.0,20511.0,13490.0,,32052.0,4527,1246,4383,1466,8910,2712,48115,59.2,9.0,48115,37.1,6.0
3955,1687,2268,48117,43373.0,45901.0,24844.0,,,37617.0,7472,1901,7461,2224,14933,4125,48117,55.1,10.0,48117,41.7,7.0
1177,554,623,48119,42432.0,44720.0,10878.0,,,,2060,509,2158,425,4218,934,48119,58.8,5.0,48119,50.8,4.0
63220,27578,35642,48121,75050.0,78489.0,53611.0,68480.0,91790.0,52184.0,304587,52747,318578,51497,623165,104244,48121,53.3,245.0,48121,37.4,169.0
2817,1289,1528,48123,49736.0,59308.0,28950.0,,,33625.0,7634,1642,7941,1559,15575,3201,48123,57.9,17.0,48123,52.8,15.0
417,192,225,48125,39700.0,40670.0,,,,9531.0,824,199,842,212,1666,411,48125,,2.0,48125,,
2003,721,1282,48127,36825.0,36998.0,,,,33056.0,3776,1372,4082,1357,7858,2729,48127,32.2,4.0,48127,,
585,247,338,48129,36681.0,38872.0,19904.0,,,30500.0,1346,377,1596,221,2942,598,48129,74.0,5.0,48129,56.3,4.0
2617,1093,1524,48131,33939.0,37661.0,,,,31831.0,4007,1549,3919,1571,7926,3120,48131,45.6,7.0,48131,33.0,5.0
3162,1312,1850,48133,34888.0,35067.0,,11875.0,,21920.0,6769,2117,7380,1794,14149,3911,48133,71.0,21.0,48133,58.8,16.0
19162,7745,11417,48135,57150.0,59738.0,48448.0,55885.0,90729.0,52243.0,57129,17173,55289,18582,112418,35755,48135,69.9,85.0,48135,50.4,61.0
205,105,100,48137,41813.0,43194.0,,,,30435.0,686,156,879,173,1565,329,48137,,2.0,48137,,
18755,8310,10445,48139,62465.0,65791.0,47199.0,37083.0,122917.0,44609.0,62565,14337,64983,13907,127548,28244,48139,64.8,91.0,48139,50.2,68.0
185728,81700,104028,48141,41637.0,42307.0,51804.0,38654.0,62375.0,37361.0,283850,99022,317237,104788,601087,203810,48141,32.9,231.0,48141,24.3,169.0
9340,3732,5608,48143,41416.0,41383.0,2499.0,,,34521.0,15099,4392,15903,4153,31002,8545,48143,53.1,21.0,48143,34.4,14.0
3417,1589,1828,48145,36079.0,39936.0,24646.0,,,23631.0,5895,1842,6431,1364,12326,3206,48145,61.0,14.0,48145,43.5,10.0
5305,2544,2761,48147,44071.0,46322.0,18967.0,35179.0,,35313.0,12352,2745,13042,2688,25394,5433,48147,78.7,36.0,48147,58.8,27.0
3021,1282,1739,48149,47808.0,49597.0,36714.0,,,45453.0,10407,1766,10148,2107,20555,3873,48149,54.2,22.0,48149,33.3,14.0
666,252,414,48151,41406.0,44922.0,33583.0,,,36250.0,1412,390,1642,390,3054,780,48151,46.7,3.0,48151,46.9,3.0
1375,613,762,48153,41026.0,43598.0,22857.0,,,35042.0,2239,772,2521,597,4760,1369,48153,61.1,5.0,48153,44.9,4.0
114,52,62,48155,36477.0,37386.0,20938.0,,,39375.0,496,73,531,64,1027,137,48155,,2.0,48155,,
53761,23618,30143,48157,89152.0,95083.0,71559.0,98990.0,108287.0,62318.0,270364,48895,285749,48185,556113,97080,48157,43.1,188.0,48157,31.9,132.0
1726,878,848,48159,41537.0,43449.0,18148.0,,,33750.0,4374,940,4210,961,8584,1901,48159,78.4,12.0,48159,51.4,8.0
2683,1178,1505,48161,44301.0,50553.0,29286.0,23214.0,,22014.0,7124,1715,7321,1907,14445,3622,48161,60.1,16.0,48161,49.0,13.0
3321,1607,1714,48163,36404.0,39200.0,,,,34116.0,6192,1524,5279,2060,11471,3584,48163,39.2,6.0,48163,31.9,5.0
2177,1018,1159,48165,57635.0,56968.0,60804.0,88523.0,,53015.0,6378,3133,6053,3244,12431,6377,48165,46.8,7.0,48165,43.3,6.0
41985,18622,23363,48167,62313.0,67608.0,34761.0,80393.0,60239.0,48705.0,124825,25166,129851,23892,254676,49058,48167,63.2,192.0,48167,54.5,162.0
432,204,228,48169,48508.0,50625.0,70592.0,,,41250.0,1545,484,1668,457,3213,941,48169,61.3,4.0,48169,,
2791,1403,1388,48171,54859.0,54232.0,,65488.0,,37083.0,9971,2226,10717,2091,20688,4317,48171,48.8,25.0,48171,37.5,19.0
40,20,20,48173,67303.0,73125.0,,,,41989.0,516,139,446,79,962,218,48173,,2.0,48173,,
1358,685,673,48175,51226.0,59837.0,21081.0,,,45185.0,3155,413,3291,434,6446,847,48175,65.5,7.0,48175,47.9,5.0
4009,1702,2307,48177,42983.0,48133.0,16300.0,,,39713.0,7522,2441,7408,2512,14930,4953,48177,47.3,12.0,48177,40.4,10.0
2824,1266,1558,48179,43288.0,44525.0,38021.0,29271.0,44583.0,37348.0,8533,2177,8407,2220,16940,4397,48179,90.1,25.0,48179,57.2,16.0
19420,8783,10637,48181,47952.0,50592.0,23841.0,42045.0,47929.0,40790.0,47981,11386,51363,10713,99344,22099,48181,78.0,120.0,48181,56.5,87.0
21769,9209,12560,48183,47639.0,52245.0,26654.0,54205.0,62131.0,41944.0,46507,12687,50620,11455,97127,24142,48183,71.9,97.0,48183,55.6,76.0
4701,2278,2423,48185,46195.0,51776.0,20698.0,25318.0,,48207.0,9497,2198,9357,2658,18854,4856,48185,48.2,15.0,48185,43.2,14.0
13924,5939,7985,48187,62420.0,63571.0,64646.0,55726.0,71542.0,50786.0,58660,10828,61380,10367,120040,21195,48187,58.6,80.0,48187,41.6,56.0
7548,3137,4411,48189,43375.0,43622.0,25000.0,30888.0,43750.0,38112.0,12814,3663,13412,3543,26226,7206,48189,60.0,21.0,48189,43.1,15.0
844,417,427,48191,30950.0,32327.0,20048.0,,,26964.0,1206,370,1129,440,2335,810,48191,65.4,4.0,48191,,
1159,545,614,48193,42432.0,43381.0,,,,21938.0,3075,826,3688,443,6763,1269,48193,59.4,9.0,48193,41.9,7.0
939,455,484,48195,44219.0,44920.0,,,,35417.0,2276,489,2246,478,4522,967,48195,61.3,4.0,48195,,
585,284,301,48197,37174.0,39415.0,13980.0,,,32500.0,1532,391,1712,345,3244,736,48197,76.1,4.0,48197,,
6684,2682,4002,48199,52614.0,55030.0,32454.0,27473.0,46290.0,55862.0,22225,4897,22861,4952,45086,9849,48199,66.4,42.0,48199,53.8,34.0
774568,348592,425976,48201,54457.0,62126.0,38401.0,47894.0,70349.0,42451.0,1618879,533586,1696701,486665,3315580,1020251,48201,56.0,1768.0,48201,40.3,1243.0
11151,5009,6142,48203,45974.0,53337.0,30366.0,22560.0,66023.0,36680.0,26040,6171,27465,6090,53505,12261,48203,79.5,62.0,48203,60.0,45.0
295,123,172,48205,63004.0,64798.0,,,,39444.0,1984,342,1959,339,3943,681,48205,,2.0,48205,,
1030,467,563,48207,39850.0,39474.0,18362.0,,,28125.0,2190,440,1988,403,4178,843,48207,40.6,4.0,48207,60.1,5.0
28783,12839,15944,48209,58583.0,60918.0,56134.0,96507.0,56364.0,46510.0,71610,15558,77014,11636,148624,27194,48209,47.2,57.0,48209,36.1,44.0
502,266,236,48211,62813.0,64406.0,,140500.0,,29773.0,1552,448,1536,527,3088,975,48211,86.4,3.0,48211,76.3,3.0
14572,6271,8301,48213,41607.0,42358.0,31667.0,44167.0,36707.0,31171.0,29559,8648,32037,7881,61596,16529,48213,89.9,104.0,48213,60.2,70.0
277104,126943,150161,48215,34782.0,34878.0,51076.0,34727.0,75781.0,32103.0,257222,135536,272464,146125,529686,281661,48215,32.7,200.0,48215,22.5,137.0
7049,3091,3958,48217,41382.0,43319.0,19859.0,27500.0,,34766.0,13420,3402,13665,3769,27085,7171,48217,69.9,35.0,48217,63.1,31.0
3297,1407,1890,48219,50665.0,51301.0,25500.0,,,46377.0,8887,2518,9184,2584,18071,5102,48219,51.8,13.0,48219,35.0,8.0
6161,2476,3685,48221,56100.0,57151.0,,,47917.0,36725.0,21323,4472,22328,4299,43651,8771,48221,64.2,56.0,48221,47.9,42.0
6972,2980,3992,48223,44396.0,46415.0,30600.0,43194.0,,36287.0,13492,3928,13916,3871,27408,7799,48223,66.0,29.0,48223,49.0,22.0
4918,1850,3068,48225,32698.0,43824.0,18939.0,,,22292.0,7507,1746,8766,1747,16273,3493,48225,63.1,22.0,48225,47.4,16.0
4787,1873,2914,48227,49575.0,51215.0,28917.0,45263.0,66944.0,38072.0,12648,2774,12681,2779,25329,5553,48227,73.3,28.0,48227,46.9,18.0
1192,491,701,48229,26384.0,26607.0,,,,21496.0,1042,336,1171,410,2213,746,48229,,2.0,48229,,
16112,7513,8599,48231,45197.0,49548.0,26572.0,,37315.0,33458.0,34231,8835,36106,8048,70337,16883,48231,80.2,82.0,48231,63.1,63.0
3493,1394,2099,48233,49353.0,51078.0,20868.0,15000.0,,36958.0,9028,1827,8766,2079,17794,3906,48233,58.4,15.0,48233,45.3,12.0
191,84,107,48235,58500.0,58833.0,,,,53000.0,667,157,679,139,1346,296,48235,,2.0,48235,,
1324,576,748,48237,50324.0,50023.0,61563.0,61071.0,,36504.0,3106,830,3066,731,6172,1561,48237,68.0,7.0,48237,54.1,6.0
1765,582,1183,48239,54926.0,57193.0,43523.0,,,48702.0,5925,1003,6262,1059,12187,2062,48239,57.5,11.0,48239,51.8,10.0
5912,2342,3570,48241,40820.0,47180.0,19221.0,,,32548.0,13089,3502,14946,3329,28035,6831,48241,60.3,29.0,48241,53.0,25.0
123,60,63,48243,50165.0,49395.0,,38750.0,,45250.0,852,206,801,310,1653,516,48243,,2.0,48243,,
47095,19637,27458,48245,43540.0,53015.0,29991.0,60238.0,51282.0,42270.0,89861,26481,96227,26458,186088,52939,48245,65.7,178.0,48245,49.8,134.0
915,479,436,48247,35521.0,36979.0,,,,34350.0,1827,803,2053,533,3880,1336,48247,,2.0,48247,,
9128,4274,4854,48249,42986.0,44526.0,58472.0,33438.0,,40919.0,15575,4670,16196,4620,31771,9290,48249,40.7,18.0,48249,35.4,16.0
18392,7958,10434,48251,58135.0,59027.0,45385.0,39583.0,38486.0,45706.0,59557,16156,61348,15792,120905,31948,48251,71.5,109.0,48251,56.1,86.0
2285,894,1391,48253,43897.0,44653.0,20332.0,64583.0,,43142.0,4378,973,5783,1398,10161,2371,48253,60.1,14.0,48253,48.5,11.0
3079,1427,1652,48255,45502.0,50851.0,,,,39315.0,5180,1052,5187,770,10367,1822,48255,72.0,12.0,48255,41.1,7.0
15016,6368,8648,48257,60391.0,64298.0,40484.0,,112625.0,44972.0,42193,10864,45071,10169,87264,21033,48257,79.4,78.0,48257,54.7,53.0
2862,1312,1550,48259,73240.0,75586.0,66976.0,,,51215.0,15599,2200,16888,2215,32487,4415,48259,44.0,21.0,48259,29.5,14.0
151,67,84,48261,36438.0,36313.0,,,,35063.0,198,97,192,78,390,175,48261,,2.0,48261,,
74,31,43,48263,47024.0,52031.0,,,,,342,64,325,40,667,104,48263,,2.0,48263,,
7718,3243,4475,48265,43810.0,44381.0,36250.0,,,36849.0,19403,4288,20616,4902,40019,9190,48265,53.9,49.0,48265,46.2,43.0
912,401,511,48267,40125.0,40089.0,,,,28958.0,1637,572,1700,518,3337,1090,48267,58.6,5.0,48267,59.2,5.0
19,10,9,48269,63250.0,63500.0,,,,,87,49,120,11,207,60,48269,,2.0,48269,,
572,280,292,48271,38281.0,39115.0,23750.0,,,40625.0,1293,445,1131,354,2424,799,48271,,2.0,48271,,
7849,3836,4013,48273,38247.0,39651.0,38167.0,,,34202.0,12628,3469,11798,3467,24426,6936,48273,53.1,16.0,48273,36.8,11.0
605,223,382,48275,40493.0,43259.0,23365.0,,,34688.0,1500,326,1457,384,2957,710,48275,67.1,4.0,48275,,
9076,3850,5226,48277,40748.0,44875.0,24327.0,29107.0,,41275.0,19257,4479,20227,4937,39484,9416,48277,78.4,50.0,48277,55.7,36.0
3173,1511,1662,48279,39851.0,41176.0,27813.0,,,32875.0,5326,1561,5166,1487,10492,3048,48279,41.0,7.0,48279,31.1,5.0
2923,1347,1576,48281,49630.0,49658.0,92665.0,92865.0,34643.0,34315.0,7621,1924,8352,1832,15973,3756,48281,74.1,19.0,48281,66.5,17.0
972,456,516,48283,37292.0,40604.0,,,,32957.0,2213,983,2280,814,4493,1797,48283,,2.0,48283,,
1765,684,1081,48285,48677.0,52666.0,25592.0,,,43311.0,7766,1495,8471,1382,16237,2877,48285,55.3,17.0,48285,33.9,11.0
2374,1078,1296,48287,53902.0,55669.0,33060.0,,,55409.0,6798,1244,6613,1521,13411,2765,48287,44.0,9.0,48287,29.9,6.0
2322,990,1332,48289,49802.0,50686.0,31250.0,,108021.0,37731.0,6688,1571,6745,1716,13433,3287,48289,67.1,19.0,48289,62.7,17.0
12548,5484,7064,48291,48729.0,51266.0,25265.0,47563.0,,42359.0,27695,8434,27444,7858,55139,16292,48291,84.3,64.0,48291,69.4,52.0
5189,2600,2589,48293,37554.0,39671.0,28309.0,35000.0,72083.0,33864.0,8344,3005,8787,2345,17131,5350,48293,81.8,24.0,48293,57.9,17.0
317,120,197,48295,63125.0,62432.0,,,,64583.0,1508,341,1254,335,2762,676,48295,,2.0,48295,,
1567,738,829,48297,50400.0,49554.0,,,,35500.0,4064,886,4176,1158,8240,2044,48297,49.4,9.0,48297,45.3,8.0
2841,1108,1733,48299,48259.0,48269.0,,,,38472.0,7598,1502,8376,1594,15974,3096,48299,53.4,24.0,48299,42.3,19.0
33,24,9,48301,,,,,,,53,21,33,10,86,31,48301,,2.0,48301,,
54155,24959,29196,48303,46075.0,48573.0,30616.0,37422.0,47363.0,38703.0,115181,25530,121041,24799,236222,50329,48303,53.2,139.0,48303,39.3,102.0
1106,451,655,48305,39526.0,39490.0,,117778.0,,28438.0,2195,677,2271,590,4466,1267,48305,47.9,4.0,48305,45.7,3.0
1522,645,877,48307,40561.0,42052.0,70042.0,21212.0,,34136.0,3306,740,3409,691,6715,1431,48307,56.0,7.0,48307,40.8,6.0
49881,22723,27158,48309,42687.0,47973.0,24579.0,39375.0,26190.0,34024.0,93849,21068,102138,20131,195987,41199,48309,66.1,164.0,48309,52.7,130.0
92,45,47,48311,46250.0,46429.0,,,,37083.0,341,64,349,24,690,88,48311,,2.0,48311,,
1938,925,1013,48313,39390.0,43257.0,19863.0,,,29679.0,3731,850,4045,1023,7776,1873,48313,53.7,8.0,48313,49.9,8.0
2264,742,1522,48315,34175.0,39071.0,21863.0,,,90375.0,3761,1077,4209,1053,7970,2130,48315,88.8,16.0,48315,80.3,14.0
692,335,357,48317,55682.0,68466.0,,,,45846.0,1974,612,1847,754,3821,1366,48317,,2.0,48317,,
577,284,293,48319,37654.0,38500.0,,,,31250.0,1535,652,1463,407,2998,1059,48319,,2.0,48319,,
7833,3539,4294,48321,40797.0,43383.0,30317.0,21125.0,,32438.0,13769,4128,14174,4112,27943,8240,48321,67.8,31.0,48321,48.2,21.0
14872,6275,8597,48323,33747.0,33580.0,,35600.0,136292.0,32749.0,18607,8661,18814,9758,37421,18419,48323,36.7,17.0,48323,23.1,10.0
6656,2989,3667,48325,57338.0,57596.0,157917.0,,,46857.0,18545,3569,19705,2956,38250,6525,48325,45.6,24.0,48325,36.6,20.0
317,114,203,48327,34464.0,35000.0,,,,23906.0,751,290,844,250,1595,540,48327,,2.0,48327,,
13238,5140,8098,48329,68806.0,72099.0,45183.0,65917.0,72764.0,57997.0,59415,15246,59879,15709,119294,30955,48329,54.0,71.0,48329,41.9,54.0
4159,1650,2509,48331,38929.0,41224.0,23571.0,38542.0,,35050.0,9871,1918,10224,1877,20095,3795,48331,65.2,23.0,48331,47.1,17.0
688,223,465,48333,43920.0,44063.0,,,,34732.0,1887,288,2108,436,3995,724,48333,45.0,4.0,48333,41.1,4.0
766,274,492,48335,49870.0,50741.0,,112500.0,,44667.0,2548,788,2835,570,5383,1358,48335,81.9,8.0,48335,58.5,6.0
2878,1274,1604,48337,46172.0,46386.0,,,,32313.0,7160,2262,7429,2328,14589,4590,48337,92.2,26.0,48337,69.9,20.0
59856,27146,32710,48339,68838.0,70752.0,50704.0,46023.0,90212.0,46097.0,203475,43375,212877,39838,416352,83213,48339,61.3,271.0,48339,47.0,201.0
4421,2081,2340,48341,49802.0,51039.0,49464.0,26648.0,41150.0,45077.0,9007,2403,8437,2236,17444,4639,48341,65.5,12.0,48341,46.1,8.0
2346,1000,1346,48343,39453.0,42213.0,28611.0,,,35865.0,4990,1057,5323,1189,10313,2246,48343,81.2,16.0,48343,70.5,14.0
181,89,92,48345,31683.0,32019.0,,,,26364.0,387,209,356,119,743,328,48345,,2.0,48345,,
14752,6761,7991,48347,39538.0,45084.0,24897.0,,,31076.0,24195,6779,26244,7459,50439,14238,48347,74.5,47.0,48347,59.7,37.0
9794,4323,5471,48349,41505.0,45385.0,23209.0,26913.0,,37083.0,18433,4787,18895,5267,37328,10054,48349,62.3,35.0,48349,59.9,35.0
1798,877,921,48351,38144.0,41646.0,28460.0,,,75458.0,5334,1736,5786,1018,11120,2754,48351,65.9,13.0,48351,57.8,11.0
3108,1410,1698,48353,37102.0,39139.0,16758.0,68438.0,,29349.0,6040,1512,5859,1464,11899,2976,48353,58.9,12.0,48353,58.9,11.0
61965,27065,34900,48355,50337.0,51341.0,34805.0,26863.0,69540.0,43720.0,135715,34184,144940,32292,280655,66476,48355,51.7,184.0,48355,38.1,134.0
1447,605,842,48357,51517.0,51062.0,,,,50903.0,4160,1228,3919,1275,8079,2503,48357,60.4,5.0,48357,56.4,5.0
214,72,142,48359,50893.0,49750.0,,,,33750.0,661,100,780,96,1441,196,48359,,2.0,48359,,
12691,5723,6968,48361,49763.0,52240.0,30454.0,28750.0,56731.0,46875.0,33263,7689,34818,6744,68081,14433,48361,82.7,80.0,48361,61.9,59.0
5425,2473,2952,48363,39516.0,40484.0,40188.0,,,33967.0,10384,3285,10729,3244,21113,6529,48363,80.8,30.0,48363,58.4,22.0
3509,1196,2313,48365,50119.0,54003.0,24766.0,,,39375.0,9312,2118,10013,2259,19325,4377,48365,70.7,21.0,48365,56.6,17.0
11785,4602,7183,48367,67288.0,68066.0,57727.0,68125.0,128594.0,54976.0,49667,9106,50821,9399,100488,18505,48367,70.9,92.0,48367,56.9,71.0
1696,751,945,48369,45326.0,47910.0,50833.0,15833.0,,39327.0,3800,1306,3758,1058,7558,2364,48369,42.0,4.0,48369,,
1643,728,915,48371,50305.0,50792.0,,26635.0,,46679.0,5464,1551,5490,1261,10954,2812,48371,40.7,6.0,48371,39.5,6.0
7279,3252,4027,48373,39662.0,41103.0,30872.0,34545.0,41014.0,33233.0,16766,4163,16862,4307,33628,8470,48373,99.4,67.0,48373,73.4,49.0
25466,10956,14510,48375,38159.0,40634.0,25489.0,35278.0,43443.0,34613.0,42602,14415,45405,13402,88007,27817,48375,73.3,83.0,48375,46.9,53.0
1586,643,943,48377,32132.0,31323.0,,,,26462.0,2424,1181,2368,1331,4792,2512,48377,,2.0,48377,,
1206,514,692,48379,48448.0,48797.0,26563.0,,250001.0,26371.0,4399,1209,4318,1044,8717,2253,48379,87.5,15.0,48379,59.9,11.0
13076,5425,7651,48381,60972.0,61373.0,46541.0,79250.0,63707.0,49408.0,53379,8330,56164,8041,109543,16371,48381,52.8,68.0,48381,38.1,49.0
552,277,275,48383,52181.0,69231.0,16250.0,,,50509.0,1249,595,1150,572,2399,1167,48383,,2.0,48383,,
541,242,299,48385,36523.0,36797.0,,,,27400.0,1270,354,1232,409,2502,763,48385,49.4,3.0,48385,56.7,4.0
2321,1053,1268,48387,31563.0,34183.0,19135.0,40000.0,,11946.0,4706,1311,5175,1168,9881,2479,48387,67.0,14.0,48387,51.5,11.0
1895,825,1070,48389,43540.0,43563.0,,43219.0,,38071.0,4368,860,4883,1253,9251,2113,48389,35.8,5.0,48389,23.6,3.0
1203,573,630,48391,44240.0,47406.0,39034.0,,,35000.0,2911,661,2944,602,5855,1263,48391,79.8,9.0,48391,69.5,8.0
14,9,5,48393,63889.0,64722.0,,,,,384,58,414,75,798,133,48393,,2.0,48393,,
2841,1286,1555,48395,46501.0,51483.0,18716.0,72857.0,,48068.0,6344,1812,6681,1499,13025,3311,48395,58.2,13.0,48395,53.6,12.0
5310,2397,2913,48397,87524.0,89717.0,69349.0,93875.0,130909.0,53052.0,36281,5253,38024,5226,74305,10479,48397,49.2,34.0,48397,34.8,24.0
2071,964,1107,48399,41526.0,43455.0,11399.0,,,37067.0,4146,935,4227,928,8373,1863,48399,61.1,10.0,48399,49.8,8.0
8510,3598,4912,48401,46173.0,50962.0,23617.0,,67250.0,40584.0,18852,5291,19359,5367,38211,10658,48401,69.8,43.0,48401,51.6,33.0
2840,1363,1477,48403,31307.0,33434.0,15350.0,,,,3777,1276,4130,1174,7907,2450,48403,71.3,16.0,48403,51.8,11.0
2105,978,1127,48405,28275.0,31232.0,16397.0,36250.0,,30781.0,3122,964,3314,1087,6436,2051,48405,73.8,11.0,48405,65.6,10.0
5419,2160,3259,48407,43029.0,44744.0,30494.0,,15795.0,47143.0,10737,2597,10586,2956,21323,5553,48407,93.0,34.0,48407,75.2,28.0
9949,4153,5796,48409,52261.0,52569.0,28250.0,43092.0,83821.0,46773.0,25544,6973,26358,6379,51902,13352,48409,73.5,51.0,48409,55.7,39.0
792,416,376,48411,39040.0,39200.0,,,,36012.0,2429,513,2000,298,4429,811,48411,60.9,6.0,48411,51.7,5.0
630,214,416,48413,55543.0,56083.0,,,,45375.0,1188,394,1217,425,2405,819,48413,,2.0,48413,,
1527,555,972,48415,56842.0,57184.0,90341.0,,,47207.0,6772,1109,6466,1407,13238,2516,48415,76.8,14.0,48415,53.2,10.0
635,340,295,48417,48750.0,47661.0,,,,37083.0,1309,307,1413,304,2722,611,48417,,2.0,48417,,
5553,2706,2847,48419,37756.0,42157.0,21458.0,,,35156.0,9184,3301,9996,3064,19180,6365,48419,73.4,23.0,48419,60.0,19.0
376,117,259,48421,51987.0,52857.0,,,,37917.0,1143,410,1167,303,2310,713,48421,,2.0,48421,,
37048,16944,20104,48423,46929.0,51908.0,30632.0,42154.0,51044.0,37376.0,82135,21568,91107,20424,173242,41992,48423,67.3,166.0,48423,47.8,118.0
1158,406,752,48425,51912.0,51282.0,,,,42257.0,3218,875,3453,874,6671,1749,48425,62.0,6.0,48425,44.5,5.0
22663,9955,12708,48427,26172.0,26318.0,,,,25961.0,18529,11332,20213,12022,38742,23354,48427,38.5,20.0,48427,25.4,13.0
1751,749,1002,48429,43951.0,44296.0,27292.0,,,35125.0,3528,915,3147,1191,6675,2106,48429,83.7,11.0,48429,68.9,9.0
208,100,108,48431,53456.0,55750.0,,,,60481.0,501,179,472,156,973,335,48431,,2.0,48431,,
264,155,109,48433,42155.0,46310.0,,,,35909.0,568,113,571,111,1139,224,48433,,2.0,48433,,
328,151,177,48435,51667.0,54500.0,,,,47106.0,1496,515,1329,601,2825,1116,48435,,2.0,48435,,
1595,708,887,48437,37040.0,40489.0,18897.0,41111.0,44821.0,29886.0,2853,616,3068,567,5921,1183,48437,49.7,5.0,48437,36.7,4.0
283264,129036,154228,48439,58711.0,63883.0,41735.0,61065.0,62265.0,43986.0,739469,189027,793135,177419,1532604,366446,48439,60.2,903.0,48439,44.4,654.0
22395,9712,12683,48441,45396.0,47737.0,34037.0,52847.0,27295.0,38182.0,51598,10570,56226,11336,107824,21906,48441,60.3,85.0,48441,46.8,67.0
186,58,128,48443,31111.0,42188.0,,,,27647.0,363,67,416,75,779,142,48443,,2.0,48443,,
1756,726,1030,48445,37475.0,38984.0,,,,32338.0,4344,1483,4434,1352,8778,2835,48445,70.7,10.0,48445,52.9,8.0
199,81,118,48447,41042.0,43333.0,,,,52353.0,585,135,639,175,1224,310,48447,,2.0,48447,,
6848,3136,3712,48449,44178.0,47468.0,26462.0,49345.0,105625.0,37860.0,12377,3575,12702,3605,25079,7180,48449,49.2,15.0,48449,45.0,14.0
16202,7037,9165,48451,46711.0,47917.0,28638.0,40417.0,61029.0,37978.0,43247,10045,46420,10234,89667,20279,48451,54.1,67.0,48451,41.5,52.0
180220,84267,95953,48453,61451.0,65193.0,42404.0,50083.0,77831.0,42788.0,454074,106121,467836,86190,921910,192311,48453,44.8,330.0,48453,32.6,230.0
2381,1166,1215,48455,34295.0,36804.0,19808.0,,,31923.0,5485,1489,5866,1491,11351,2980,48455,90.7,23.0,48455,74.7,19.0
3159,1489,1670,48457,41360.0,42113.0,27337.0,,,23373.0,7657,1696,8058,1627,15715,3323,48457,72.8,23.0,48457,60.6,19.0
5322,2251,3071,48459,46673.0,48697.0,35148.0,,,35365.0,16130,3570,16157,3745,32287,7315,48459,75.5,39.0,48459,57.6,29.0
657,278,379,48461,46131.0,56510.0,,,,34837.0,1214,378,1316,439,2530,817,48461,,2.0,48461,89.1,3.0
5248,2307,2941,48463,38568.0,38432.0,,,250001.0,32373.0,9925,3035,10651,2984,20576,6019,48463,38.1,12.0,48463,32.7,10.0
9738,4303,5435,48465,42174.0,42015.0,47074.0,43438.0,,39710.0,17516,5036,17926,5882,35442,10918,48465,35.4,17.0,48465,31.3,15.0
8787,3991,4796,48467,44002.0,44872.0,43681.0,,22177.0,35561.0,20005,5621,21102,5344,41107,10965,48467,68.7,52.0,48467,57.5,42.0
14531,6219,8312,48469,51758.0,53785.0,37089.0,,95117.0,41575.0,35369,8179,36915,8540,72284,16719,48469,57.6,56.0,48469,39.5,38.0
12642,5139,7503,48471,37666.0,42535.0,25845.0,,54293.0,27708.0,19845,3706,24287,4320,44132,8026,48471,68.5,43.0,48471,46.6,28.0
7505,3529,3976,48473,51348.0,60578.0,33322.0,,,39656.0,17736,5186,17510,5160,35246,10346,48473,53.7,21.0,48473,36.9,15.0
1831,905,926,48475,51345.0,51326.0,39423.0,,,49653.0,4602,906,4370,1217,8972,2123,48475,69.8,9.0,48475,57.7,7.0
4325,1895,2430,48477,51269.0,54675.0,32744.0,71250.0,79358.0,36934.0,13553,3285,14529,2211,28082,5496,48477,44.7,22.0,48477,35.4,17.0
82307,36856,45451,48479,38862.0,38614.0,123355.0,45406.0,89458.0,37705.0,85837,40609,91945,42511,177782,83120,48479,30.3,51.0,48479,20.7,35.0
7178,3232,3946,48481,45176.0,48528.0,26340.0,,,38786.0,15744,4348,16861,4001,32605,8349,48481,49.7,25.0,48481,39.2,19.0
862,419,443,48483,52221.0,54383.0,42188.0,,208333.0,39271.0,2148,673,2094,633,4242,1306,48483,54.0,4.0,48483,59.1,4.0
20712,8817,11895,48485,45543.0,48105.0,28551.0,61122.0,68400.0,36052.0,45680,9621,51992,10046,97672,19667,48485,74.9,106.0,48485,55.8,79.0
2275,1155,1120,48487,41630.0,47349.0,20221.0,41071.0,60652.0,48859.0,5337,1132,5308,1217,10645,2349,48487,62.3,11.0,48487,43.5,7.0
7604,3426,4178,48489,26495.0,26310.0,,,,22447.0,6349,3273,6820,3070,13169,6343,48489,40.4,9.0,48489,35.2,7.0
35014,15936,19078,48491,73750.0,73781.0,57404.0,53713.0,109278.0,58057.0,199404,30976,211551,27780,410955,58756,48491,50.9,178.0,48491,35.5,122.0
4783,2127,2656,48493,68100.0,69497.0,46538.0,,,51747.0,19112,3384,19368,2993,38480,6377,48493,43.7,22.0,48493,35.9,18.0
1040,370,670,48495,55756.0,56221.0,46731.0,,,57039.0,2829,879,2766,995,5595,1874,48495,67.8,5.0,48495,49.1,4.0
7015,2646,4369,48497,56897.0,57258.0,60650.0,74222.0,86875.0,45595.0,24533,5501,24716,5520,49249,11021,48497,63.1,41.0,48497,55.2,35.0
6073,2621,3452,48499,45686.0,47046.0,29028.0,29226.0,43125.0,37617.0,16976,3633,17291,4003,34267,7636,48499,75.4,57.0,48499,57.9,44.0
979,308,671,48501,56153.0,57370.0,,,,57159.0,3063,1048,3125,966,6188,2014,48501,66.2,5.0,48501,52.8,4.0
2751,1308,1443,48503,44693.0,46424.0,20774.0,,23892.0,35514.0,6888,2148,7086,1934,13974,4082,48503,74.2,20.0,48503,60.2,16.0
5334,2552,2782,48505,32162.0,31974.0,,,,31379.0,4838,2306,4663,2467,9501,4773,48505,38.2,4.0,48505,,
3943,1409,2534,48507,26672.0,24315.0,,,,25897.0,4441,1286,4639,1440,9080,2726,48507,,2.0,48507,,
797,374,423,49001,50282.0,50847.0,,,,32321.0,2849,421,2673,440,5522,861,49001,,2.0,49001,,
4779,2317,2462,49003,55038.0,55631.0,,,51607.0,34719.0,23124,2303,23051,2112,46175,4415,49003,20.4,10.0,49003,17.6,8.0
17713,8262,9451,49005,50497.0,51159.0,,23878.0,27155.0,40308.0,51912,6142,53168,5493,105080,11635,49005,15.8,12.0,49005,9.2,7.0
3113,1350,1763,49007,46900.0,46921.0,39904.0,84219.0,60938.0,43387.0,8742,1467,9307,1195,18049,2662,49007,51.1,12.0,49007,34.5,8.0
47,11,36,49009,56750.0,56750.0,,,,,290,10,335,16,625,26,49009,,2.0,49009,,
24718,10960,13758,49011,71112.0,72441.0,58924.0,88000.0,66839.0,49562.0,145687,14662,147007,12969,292694,27631,49011,25.0,57.0,49011,17.2,38.0
2019,821,1198,49013,61133.0,61377.0,,45417.0,100179.0,60515.0,8292,1519,8101,1535,16393,3054,49013,50.2,8.0,49013,34.9,6.0
1188,482,706,49015,49787.0,49794.0,,,,24856.0,4683,715,4601,677,9284,1392,49015,,2.0,49015,,
873,358,515,49017,42614.0,42386.0,,,,,1979,488,1917,457,3896,945,49017,,2.0,49017,,
1740,877,863,49019,41312.0,41570.0,,46713.0,,24222.0,3426,1354,3470,1073,6896,2427,49019,61.9,7.0,49019,44.1,5.0
9727,4998,4729,49021,43855.0,45370.0,,25301.0,91917.0,22097.0,18610,4636,19409,4043,38019,8679,49021,29.5,11.0,49021,19.7,7.0
1464,746,718,49023,54761.0,55462.0,,31250.0,,50536.0,4438,868,4299,652,8737,1520,49023,,2.0,49023,,
562,233,329,49025,50194.0,46956.0,,,,,2577,854,3145,534,5722,1388,49025,32.6,4.0,49025,,
1602,713,889,49027,51593.0,55658.0,,,,29524.0,5162,1151,5142,975,10304,2126,49027,25.8,4.0,49027,,
557,262,295,49029,74314.0,74755.0,,,,,4663,545,4527,511,9190,1056,49029,,2.0,49029,,
376,190,186,49031,35980.0,36107.0,,,,22292.0,793,191,691,151,1484,342,49031,,2.0,49031,,
333,115,218,49033,50781.0,50938.0,,,,22344.0,971,117,995,204,1966,321,49033,,2.0,49033,,
131630,61427,70203,49035,62117.0,65111.0,37500.0,35938.0,61677.0,44209.0,451726,84207,463806,71201,915532,155408,49035,32.1,260.0,49035,22.1,177.0
4149,1972,2177,49037,41484.0,57593.0,,24132.0,,,5357,1973,5604,1951,10961,3924,49037,,2.0,49037,,
4043,1618,2425,49039,50323.0,50690.0,,33618.0,,42500.0,10296,2052,11239,2099,21535,4151,49039,29.3,8.0,49039,18.8,5.0
2973,1222,1751,49041,46291.0,47404.0,,22216.0,,23929.0,8616,1742,8384,1772,17000,3514,49041,30.3,7.0,49041,21.3,5.0
3001,1546,1455,49043,91773.0,92425.0,47426.0,,135913.0,39911.0,17112,2404,16860,2021,33972,4425,49043,18.2,6.0,49043,14.4,4.0
4339,1877,2462,49045,63552.0,64735.0,91471.0,53056.0,,49444.0,27050,3351,27218,2768,54268,6119,49045,40.2,16.0,49045,28.9,12.0
3261,1530,1731,49047,66815.0,69619.0,,41818.0,,42136.0,14957,2986,14652,2753,29609,5739,49047,27.6,7.0,49047,24.3,6.0
71110,33388,37722,49049,62180.0,62884.0,44643.0,42825.0,54917.0,45308.0,242176,32950,241635,31570,483811,64520,49049,18.5,56.0,49049,12.4,37.0
2633,1199,1434,49051,66486.0,67269.0,,,,45330.0,11263,2016,11400,1808,22663,3824,49051,34.5,6.0,49051,23.1,4.0
21893,10244,11649,49053,50774.0,51384.0,27841.0,42188.0,51588.0,35670.0,59249,13064,62096,12364,121345,25428,49053,29.7,55.0,49053,22.5,41.0
414,214,200,49055,40645.0,41048.0,,,,34896.0,1070,327,1076,231,2146,558,49055,,2.0,49055,,
30547,14446,16101,49057,56581.0,58326.0,34482.0,35893.0,53430.0,38573.0,100971,16736,102594,15564,203565,32300,49057,33.6,69.0,49057,25.4,51.0
6384,2475,3909,51001,39412.0,45737.0,28401.0,,,42768.0,12900,2962,14094,2753,26994,5715,51001,91.1,46.0,51001,76.7,38.0
9714,4431,5283,51003,68449.0,71625.0,39587.0,,71897.0,48777.0,44260,4170,49034,4068,93294,8238,51003,41.0,49.0,51003,34.1,41.0
2682,1184,1498,51005,45007.0,45865.0,27500.0,,,46583.0,7093,703,7364,666,14457,1369,51005,54.8,14.0,51005,61.3,16.0
1471,792,679,51007,56850.0,67579.0,42746.0,42798.0,,,5483,971,5376,848,10859,1819,51007,75.3,13.0,51007,65.5,11.0
4086,2099,1987,51009,47558.0,51276.0,30625.0,83125.0,64886.0,,13171,2199,15012,1588,28183,3787,51009,64.7,28.0,51009,51.8,23.0
2668,1172,1496,51011,48823.0,53854.0,26786.0,,,61875.0,6642,713,6903,879,13545,1592,51011,75.5,15.0,51011,53.8,11.0
19996,9134,10862,51013,105763.0,119390.0,62463.0,,88222.0,65003.0,97738,11574,101234,9734,198972,21308,51013,37.2,61.0,51013,26.3,43.0
6694,2535,4159,51015,54558.0,55281.0,30795.0,24491.0,,46250.0,30103,3876,32697,3556,62800,7432,51015,51.7,53.0,51015,45.9,46.0
347,185,162,51017,43646.0,44097.0,,,,,1919,287,1971,344,3890,631,51017,66.0,5.0,51017,41.6,4.0
621,287,334,51021,45294.0,45315.0,,,,,2578,245,2649,255,5227,500,51021,83.5,8.0,51021,54.2,5.0
2701,1248,1453,51023,60454.0,60956.0,50962.0,,,62125.0,15366,893,15919,708,31285,1601,51023,56.4,26.0,51023,41.9,20.0
3298,1396,1902,51025,36919.0,46318.0,29248.0,,,37574.0,6129,1200,7046,841,13175,2041,51025,74.6,18.0,51025,46.5,11.0
5841,2717,3124,51027,29679.0,30070.0,,,100938.0,,9635,1386,10011,1414,19646,2800,51027,53.9,18.0,51027,56.4,19.0
2867,1283,1584,51029,40331.0,41935.0,35682.0,,,101050.0,6196,1305,6470,1069,12666,2374,51029,76.7,17.0,51029,54.2,11.0
7309,3096,4213,51031,47699.0,49710.0,39872.0,,36231.0,61650.0,22926,3396,25433,2771,48359,6167,51031,54.2,40.0,51031,47.0,35.0
3601,1521,2080,51033,59227.0,63107.0,51291.0,130648.0,35938.0,63487.0,11117,1658,12880,1543,23997,3201,51033,83.6,29.0,51033,64.6,21.0
5017,2237,2780,51035,35000.0,35059.0,,,,51071.0,12746,2169,12772,2031,25518,4200,51035,56.4,26.0,51035,55.4,26.0
933,379,554,51036,49563.0,61955.0,40891.0,63500.0,,93750.0,3040,478,3211,366,6251,844,51036,51.9,7.0,51036,55.6,7.0
2589,1050,1539,51037,35079.0,38106.0,25353.0,,,,5037,994,5142,1002,10179,1996,51037,59.5,11.0,51037,42.1,8.0
24002,10156,13846,51041,72609.0,76423.0,62131.0,39375.0,83229.0,50016.0,140593,15440,154425,14959,295018,30399,51041,69.4,211.0,51041,47.6,143.0
1556,734,822,51043,71295.0,75668.0,32153.0,,,,6011,910,6253,930,12264,1840,51043,63.4,13.0,51043,64.9,13.0
611,218,393,51045,44330.0,44263.0,,,,,2140,345,2461,249,4601,594,51045,58.9,5.0,51045,54.0,4.0
4320,1806,2514,51047,66697.0,70034.0,52992.0,,92222.0,47100.0,19760,3129,21227,2709,40987,5838,51047,70.6,35.0,51047,54.3,26.0
1996,1065,931,51049,39301.0,43476.0,29350.0,,,,3922,1018,4156,763,8078,1781,51049,64.8,9.0,51049,59.2,8.0
3225,1513,1712,51051,33624.0,33638.0,24000.0,,,,6679,911,6684,794,13363,1705,51051,76.1,17.0,51051,71.6,16.0
4061,1686,2375,51053,51397.0,53457.0,41832.0,,123250.0,68669.0,12015,1568,12668,1434,24683,3002,51053,70.9,24.0,51053,55.0,19.0
1533,584,949,51057,42760.0,48322.0,36791.0,67841.0,,,4431,704,5217,723,9648,1427,51057,81.5,13.0,51057,61.8,10.0
66762,29498,37264,51059,112552.0,123313.0,81908.0,68824.0,106700.0,75045.0,484051,64076,509943,57197,993994,121273,51059,40.0,390.0,51059,25.6,242.0
3762,1662,2100,51061,91609.0,95425.0,47431.0,114306.0,90278.0,63967.0,29662,3417,31138,2792,60800,6209,51061,48.7,37.0,51061,41.3,30.0
1551,803,748,51063,48005.0,50096.0,18365.0,,,36875.0,6874,900,6930,731,13804,1631,51063,47.5,10.0,51063,38.8,8.0
1618,666,952,51065,63938.0,65405.0,56350.0,,,36603.0,10621,1184,11949,956,22570,2140,51065,66.4,22.0,51065,39.4,13.0
8123,3695,4428,51067,46870.0,48167.0,38289.0,16635.0,,30711.0,23707,3737,24950,3592,48657,7329,51067,53.1,42.0,51067,43.4,34.0
5247,2162,3085,51069,69098.0,68896.0,69539.0,75089.0,69698.0,55353.0,34801,4806,36267,4491,71068,9297,51069,72.3,64.0,51069,52.6,46.0
1891,851,1040,51071,46390.0,46840.0,,,50875.0,46705.0,6871,1369,7376,1158,14247,2527,51071,66.7,16.0,51071,64.1,16.0
2735,1165,1570,51073,61121.0,61466.0,53108.0,102212.0,,83202.0,15163,2448,16690,1875,31853,4323,51073,88.7,42.0,51073,72.2,34.0
1163,520,643,51075,79330.0,87143.0,39798.0,,,61429.0,9463,565,9654,727,19117,1292,51075,66.3,20.0,51075,44.3,13.0
3244,1359,1885,51077,29942.0,30546.0,10990.0,,,26384.0,6406,1063,6899,929,13305,1992,51077,63.6,16.0,51077,62.7,16.0
1853,751,1102,51079,61550.0,62352.0,42625.0,,140543.0,66600.0,7787,1368,8152,1421,15939,2789,51079,62.5,14.0,51079,44.0,9.0
1490,497,993,51081,38012.0,48517.0,32798.0,,,,2862,304,3991,407,6853,711,51081,81.5,12.0,51081,53.1,8.0
6675,3041,3634,51083,35240.0,40330.0,26535.0,,44800.0,28170.0,13598,2820,15992,2384,29590,5204,51083,58.7,32.0,51083,49.6,27.0
5976,2392,3584,51085,78645.0,81174.0,58191.0,60750.0,78750.0,70859.0,45981,3228,48666,2723,94647,5951,51085,80.7,94.0,51085,53.0,60.0
33914,14118,19796,51087,61934.0,69574.0,46090.0,55347.0,87371.0,49513.0,131760,17728,151314,16043,283074,33771,51087,57.2,190.0,51087,46.2,154.0
9520,4167,5353,51089,35293.0,36789.0,28970.0,,,35923.0,21245,3589,23490,3644,44735,7233,51089,69.9,56.0,51089,54.7,44.0
282,88,194,51091,43914.0,43816.0,,,,,788,215,1033,208,1821,423,51091,,2.0,51091,,
4137,1943,2194,51093,65741.0,72742.0,42596.0,,,101176.0,15400,1844,16581,1445,31981,3289,51093,63.0,29.0,51093,47.6,22.0
5648,2559,3089,51095,75710.0,80998.0,48446.0,,112273.0,59216.0,30377,2719,33417,2569,63794,5288,51095,42.8,45.0,51095,34.0,37.0
949,470,479,51097,48292.0,52000.0,45086.0,,,,3046,620,2929,511,5975,1131,51097,80.1,8.0,51097,69.0,7.0
1366,522,844,51099,81688.0,82741.0,68406.0,,72829.0,185667.0,11106,1084,11501,817,22607,1901,51099,92.7,19.0,51099,55.4,12.0
1897,835,1062,51101,62031.0,65246.0,43594.0,65625.0,,53523.0,7059,784,7410,785,14469,1569,51101,60.8,11.0,51101,48.2,9.0
1246,551,695,51103,50374.0,56498.0,37628.0,,140577.0,,4506,709,5247,581,9753,1290,51103,58.5,15.0,51103,50.8,13.0
6027,2490,3537,51105,31086.0,31218.0,,,,,9978,1920,10177,1706,20155,3626,51105,82.4,27.0,51105,85.9,28.0
14047,5850,8197,51107,123453.0,125761.0,100669.0,83162.0,136005.0,77596.0,157541,14975,163902,12866,321443,27841,51107,40.8,85.0,51107,34.2,67.0
3385,1584,1801,51109,57829.0,59712.0,45903.0,31350.0,103221.0,46613.0,13771,2941,14541,2635,28312,5576,51109,80.0,35.0,51109,59.7,26.0
2279,1015,1264,51111,39506.0,44361.0,29583.0,,,25313.0,4355,870,5104,862,9459,1732,51111,67.5,12.0,51111,57.7,11.0
1613,725,888,51113,47736.0,48930.0,19531.0,,,91625.0,5113,1182,5844,832,10957,2014,51113,81.9,15.0,51113,47.1,9.0
613,274,339,51115,63845.0,65780.0,47875.0,,,,3671,370,4387,333,8058,703,51115,64.6,10.0,51115,47.6,9.0
5975,2697,3278,51117,37356.0,42855.0,25281.0,,,55655.0,11851,2293,14112,1936,25963,4229,51117,75.2,39.0,51117,63.5,33.0
982,462,520,51119,54654.0,60625.0,28438.0,,,,4455,555,4995,345,9450,900,51119,79.4,16.0,51119,60.1,13.0
21707,11805,9902,51121,46663.0,48441.0,37961.0,50819.0,32569.0,38137.0,45251,4418,43141,3090,88392,7508,51121,54.0,43.0,51121,41.7,33.0
2159,1131,1028,51125,47118.0,51037.0,26657.0,,,,6176,1016,6693,916,12869,1932,51125,92.0,21.0,51125,62.3,15.0
1327,485,842,51127,73041.0,72346.0,75000.0,,141027.0,107672.0,8949,665,8786,620,17735,1285,51127,76.4,15.0,51127,68.1,13.0
2730,1193,1537,51131,35055.0,47604.0,18805.0,,61354.0,,4367,1341,5069,1109,9436,2450,51131,83.6,17.0,51131,73.6,15.0
1352,537,815,51133,51885.0,58750.0,41201.0,,,,5443,494,5866,501,11309,995,51133,71.6,20.0,51133,52.3,14.0
3444,1760,1684,51135,36284.0,44493.0,28375.0,,,35435.0,6074,1133,6609,673,12683,1806,51135,67.6,14.0,51135,52.4,11.0
4105,1637,2468,51137,65166.0,66077.0,36964.0,,115938.0,67174.0,14125,2432,15708,1808,29833,4240,51137,77.8,37.0,51137,54.2,26.0
3880,1813,2067,51139,43895.0,44331.0,27969.0,,,33190.0,9798,1753,10341,1756,20139,3509,51139,66.1,22.0,51139,59.8,20.0
3818,1918,1900,51141,33982.0,35120.0,31060.0,,,11452.0,7405,1494,7873,1265,15278,2759,51141,51.2,15.0,51141,48.3,15.0
9944,3897,6047,51143,41824.0,44450.0,34851.0,,59688.0,39417.0,26329,3758,28133,3766,54462,7524,51143,59.3,54.0,51143,55.1,50.0
1252,476,776,51145,77896.0,80565.0,41938.0,,161063.0,73036.0,11450,1149,12004,1018,23454,2167,51145,65.8,21.0,51145,51.8,16.0
3883,1503,2380,51147,41697.0,49571.0,28152.0,,,,9331,1508,10247,1213,19578,2721,51147,53.3,13.0,51147,45.7,11.0
3370,1612,1758,51149,61857.0,68388.0,56792.0,50313.0,83000.0,44032.0,14557,1641,15041,1285,29598,2926,51149,65.2,24.0,51149,49.0,17.0
28739,12982,15757,51153,98657.0,104209.0,87787.0,66432.0,94287.0,70087.0,181415,29623,192841,25170,374256,54793,51153,48.4,133.0,51153,40.9,107.0
4506,2063,2443,51155,47495.0,47041.0,49286.0,,,,14622,1853,15274,1840,29896,3693,51155,62.8,32.0,51155,59.1,30.0
733,323,410,51157,57210.0,60313.0,45544.0,,,41369.0,3041,626,3185,561,6226,1187,51157,65.2,7.0,51157,41.2,5.0
748,289,459,51159,47288.0,50584.0,35511.0,,,,3021,350,3382,351,6403,701,51159,72.9,9.0,51159,44.5,6.0
7607,3482,4125,51161,60519.0,60643.0,54063.0,96750.0,82792.0,62031.0,40502,3370,45602,2595,86104,5965,51161,55.2,72.0,51161,42.7,56.0
3085,1379,1706,51163,48901.0,49480.0,,,55795.0,63009.0,9518,1452,9803,1492,19321,2944,51163,32.0,12.0,51163,37.1,14.0
8471,3839,4632,51165,53744.0,53801.0,60694.0,,85833.0,34768.0,32610,5364,35016,4421,67626,9785,51165,49.4,51.0,51165,39.2,40.0
5777,2322,3455,51167,35045.0,35181.0,21336.0,,,,11370,2263,12398,1988,23768,4251,51167,63.5,25.0,51167,65.4,26.0
4406,1945,2461,51169,37240.0,37228.0,,,100208.0,,9408,1489,9941,1111,19349,2600,51169,72.1,25.0,51169,67.2,24.0
5138,2009,3129,51171,49406.0,49618.0,47917.0,140000.0,,36489.0,17819,2682,19126,2645,36945,5327,51171,67.4,41.0,51171,54.3,33.0
5815,2757,3058,51173,37983.0,38430.0,,,,42500.0,12935,2252,14219,1792,27154,4044,51173,92.0,42.0,51173,79.5,36.0
2649,1175,1474,51175,48962.0,63717.0,31972.0,97679.0,,18462.0,7002,1249,7511,1110,14513,2359,51175,63.8,16.0,51175,47.6,12.0
10396,4565,5831,51177,78125.0,81628.0,68838.0,112574.0,79886.0,64973.0,54453,7609,58090,6628,112543,14237,51177,68.2,77.0,51177,52.9,57.0
6948,2928,4020,51179,97144.0,98129.0,108560.0,95000.0,69286.0,73553.0,57845,6038,62285,4940,120130,10978,51179,77.4,72.0,51179,53.0,46.0
881,403,478,51181,53673.0,60852.0,43696.0,,,,2798,551,3020,454,5818,1005,51181,60.9,6.0,51181,53.7,5.0
1362,439,923,51183,39194.0,51500.0,30137.0,,,,2766,202,3316,342,6082,544,51183,90.7,14.0,51183,69.2,10.0
7518,3186,4332,51185,37664.0,38035.0,15133.0,,,,17568,3180,19194,2758,36762,5938,51185,67.6,42.0,51185,64.5,40.0
3696,1533,2163,51187,61454.0,62236.0,47277.0,39712.0,47639.0,40682.0,16779,2310,16876,2147,33655,4457,51187,72.1,31.0,51187,56.7,24.0
6845,3161,3684,51191,43310.0,43426.0,34301.0,,,24449.0,23508,3123,24471,3018,47979,6141,51191,75.6,60.0,51191,61.9,49.0
2323,1045,1278,51193,47911.0,50899.0,36763.0,,,,6984,1480,7735,1204,14719,2684,51193,74.7,22.0,51193,52.3,15.0
8414,3646,4768,51195,37407.0,37889.0,10298.0,,,22692.0,16419,2526,17017,2358,33436,4884,51195,84.3,42.0,51195,75.0,36.0
4356,2050,2306,51197,41360.0,41460.0,34583.0,,36500.0,36250.0,12470,1769,12508,2170,24978,3939,51197,74.7,31.0,51197,48.2,21.0
4198,1815,2383,51199,81749.0,86583.0,62089.0,,84881.0,67344.0,28042,2094,31490,1852,59532,3946,51199,48.4,33.0,51199,37.0,25.0
12359,4903,7456,51510,89134.0,105774.0,54350.0,,96705.0,61162.0,58340,11458,66921,9509,125261,20967,51510,28.8,34.0,51510,26.4,33.0
3496,1410,2086,51520,35368.0,36418.0,21900.0,,,,6543,1492,8273,1059,14816,2551,51520,54.6,14.0,51520,76.6,20.0
1755,529,1226,51530,29097.0,27253.0,,,,,2489,551,2995,555,5484,1106,51530,107.3,8.0,51530,84.3,6.0
10995,5182,5813,51540,49775.0,56756.0,32816.0,,41020.0,58450.0,19142,2389,20847,2328,39989,4717,51540,114.7,38.0,51540,55.1,19.0
21734,8627,13107,51550,68620.0,77034.0,52592.0,49571.0,89239.0,65635.0,92540,9502,106793,9602,199333,19104,51550,71.6,149.0,51550,51.8,105.0
1974,837,1137,51570,50304.0,53425.0,40829.0,120714.0,40000.0,47261.0,7065,947,8246,1010,15311,1957,51570,69.5,17.0,51570,47.2,12.0
1437,587,850,51580,34746.0,37426.0,32598.0,,,,2384,431,2323,418,4707,849,51580,167.0,13.0,51580,66.2,5.0
9629,4000,5629,51590,32315.0,39110.0,27783.0,20833.0,49417.0,40625.0,16255,2690,19869,2495,36124,5185,51590,92.4,57.0,51590,56.0,35.0
1907,862,1045,51595,28601.0,46000.0,22511.0,,,,1825,684,2492,456,4317,1140,51595,56.2,4.0,51595,64.3,5.0
1593,831,762,51600,105297.0,111375.0,102130.0,,114667.0,81385.0,9803,1455,10508,1132,20311,2587,51600,26.5,7.0,51600,40.3,11.0
361,124,237,51610,120522.0,136311.0,85962.0,,72134.0,81607.0,6120,166,6616,309,12736,475,51610,44.8,5.0,51610,25.1,3.0
1762,962,800,51620,32399.0,51164.0,29211.0,,,19324.0,3109,605,3958,655,7067,1260,51620,82.8,9.0,51620,47.6,5.0
4108,1727,2381,51630,51762.0,58952.0,38750.0,,105125.0,34522.0,10932,1700,12554,1962,23486,3662,51630,95.1,20.0,51630,49.1,11.0
1766,913,853,51640,30604.0,30594.0,31389.0,,,50556.0,2680,540,2962,404,5642,944,51640,80.2,8.0,51640,36.8,4.0
20187,8590,11597,51650,49190.0,57353.0,40539.0,,48542.0,55417.0,53054,8905,62299,7512,115353,16417,51650,76.8,110.0,51650,56.0,80.0
14326,6628,7698,51660,38750.0,39018.0,32670.0,,40455.0,37392.0,20221,3794,22806,3851,43027,7645,51660,91.2,29.0,51660,48.2,16.0
4165,1792,2373,51670,39064.0,40483.0,32881.0,,,62716.0,8816,1592,10088,1452,18904,3044,51670,89.5,24.0,51670,66.6,18.0
678,205,473,51678,34017.0,31136.0,34857.0,,45804.0,39911.0,2913,214,2361,155,5274,369,51678,110.1,7.0,51678,,
16775,7243,9532,51680,39589.0,47725.0,25422.0,,64167.0,41019.0,31269,4648,36055,4663,67324,9311,51680,75.9,61.0,51680,52.8,44.0
3945,1572,2373,51683,72890.0,75170.0,68750.0,,51522.0,59392.0,16098,4164,16731,3696,32829,7860,51683,55.1,14.0,51683,38.8,10.0
1232,646,586,51685,73528.0,69982.0,,,92019.0,61046.0,5839,2304,5675,1721,11514,4025,51685,,2.0,51685,42.0,4.0
3105,1269,1836,51690,29587.0,32465.0,24203.0,,,55313.0,4866,1064,6285,1056,11151,2120,51690,70.8,14.0,51690,81.9,17.0
26984,11787,15197,51700,50077.0,59736.0,39785.0,57808.0,50571.0,43819.0,68381,12028,81163,10640,149544,22668,51700,75.2,125.0,51700,57.3,94.0
46288,21633,24655,51710,44480.0,56559.0,31925.0,38750.0,54193.0,40487.0,87440,19429,96562,15844,184002,35273,51710,75.6,152.0,51710,53.6,108.0
949,369,580,51720,27731.0,27031.0,36393.0,,,,1367,234,2155,193,3522,427,51720,100.5,5.0,51720,,
8795,3584,5211,51730,31798.0,41766.0,29770.0,,,32008.0,11320,2846,14554,2519,25874,5365,51730,113.1,45.0,51730,68.9,27.0
502,134,368,51735,83735.0,83766.0,140375.0,,59917.0,91250.0,5482,338,5865,252,11347,590,51735,50.2,7.0,51735,44.2,7.0
17000,6563,10437,51740,45676.0,54553.0,36833.0,38162.0,42188.0,37016.0,37167,6080,42515,6536,79682,12616,51740,78.3,81.0,51740,60.3,63.0
5497,2608,2889,51750,29912.0,31834.0,19489.0,,,23750.0,7317,805,8094,670,15411,1475,51750,87.3,9.0,51750,67.2,7.0
51828,22792,29036,51760,40758.0,57279.0,28230.0,24509.0,45932.0,32486.0,79997,19858,95434,15861,175431,35719,51760,76.1,151.0,51760,57.3,115.0
20514,8945,11569,51770,39930.0,43256.0,29855.0,,34153.0,29071.0,38410,8301,43908,6823,82318,15124,51770,95.5,110.0,51770,65.3,75.0
2578,1082,1496,51775,50068.0,51080.0,27500.0,,40278.0,,10218,1258,11713,1306,21931,2564,51775,71.5,24.0,51775,51.0,17.0
4052,1677,2375,51790,40842.0,41319.0,34565.0,,38320.0,61719.0,9175,1415,11390,1665,20565,3080,51790,96.8,35.0,51790,54.3,20.0
9835,4190,5645,51800,65499.0,78573.0,46878.0,82727.0,70966.0,65259.0,35051,4543,40616,3608,75667,8151,51800,68.3,59.0,51800,48.2,41.0
36267,15055,21212,51810,66634.0,71156.0,51265.0,69201.0,72597.0,54825.0,177592,22265,203264,19818,380856,42083,51810,67.5,279.0,51810,46.8,191.0
3796,1496,2300,51820,45643.0,47439.0,26978.0,,59327.0,26897.0,8151,1881,9559,1418,17710,3299,51820,88.3,24.0,51820,50.9,14.0
2401,1108,1293,51830,48639.0,53378.0,33378.0,,2499.0,45329.0,5859,694,7727,292,13586,986,51830,127.9,19.0,51830,28.7,4.0
4200,1784,2416,51840,45363.0,48133.0,40696.0,,41588.0,30885.0,10765,2501,11474,2166,22239,4667,51840,57.1,17.0,51840,51.9,16.0
3124,1498,1626,50001,59688.0,59734.0,,,63750.0,63355.0,16935,1355,17583,841,34518,2196,50001,65.6,30.0,50001,45.6,20.0
4735,2226,2509,50003,49573.0,49907.0,55613.0,,118382.0,131852.0,16484,1227,17710,683,34194,1910,50003,64.3,36.0,50003,46.0,26.0
3733,1458,2275,50005,45323.0,45475.0,,,41250.0,36042.0,13745,1374,14869,633,28614,2007,50005,74.8,29.0,50005,57.2,23.0
17045,7513,9532,50007,65350.0,66990.0,40873.0,31406.0,52023.0,54875.0,73192,4265,78128,2958,151320,7223,50007,65.5,104.0,50007,42.8,67.0
929,412,517,50009,36599.0,36895.0,,9375.0,60893.0,28125.0,2775,336,2882,214,5657,550,50009,77.6,8.0,50009,48.7,5.0
4147,1893,2254,50011,58199.0,58139.0,,70259.0,45441.0,82757.0,21866,1751,23348,910,45214,2661,50011,79.6,41.0,50011,59.0,29.0
598,275,323,50013,62608.0,63168.0,,,,41250.0,3238,181,3398,135,6636,316,50013,89.1,7.0,50013,44.6,4.0
2887,1126,1761,50015,50939.0,50715.0,,78813.0,,75809.0,11169,1231,11606,926,22775,2157,50015,66.1,19.0,50015,43.9,13.0
3498,1601,1897,50017,53869.0,54159.0,73958.0,45357.0,49167.0,32115.0,13236,1091,13853,662,27089,1753,50017,67.2,24.0,50017,56.9,21.0
4070,1866,2204,50019,42831.0,43095.0,,25455.0,,56250.0,11937,1229,12539,798,24476,2027,50019,59.4,23.0,50019,48.5,19.0
7276,3507,3769,50021,49372.0,49478.0,170195.0,,51111.0,44464.0,27003,2340,29043,1462,56046,3802,50021,72.6,63.0,50021,51.3,44.0
5729,2530,3199,50023,58788.0,58636.0,85074.0,87642.0,83156.0,44716.0,27153,1838,28500,1139,55653,2977,50023,61.0,46.0,50023,47.6,36.0
5421,2361,3060,50025,51045.0,51544.0,55508.0,45781.0,48500.0,30938.0,19827,1631,20905,1054,40732,2685,50025,58.9,36.0,50025,41.8,25.0
6041,2725,3316,50027,52965.0,53036.0,89922.0,,57500.0,33906.0,24618,2209,26757,1685,51375,3894,50027,67.4,57.0,50027,45.7,39.0
4019,1948,2071,53001,46564.0,52046.0,,,,40060.0,7244,2345,7393,1866,14637,4211,53001,37.0,6.0,53001,29.9,5.0
3301,1474,1827,53003,44394.0,44467.0,,,101583.0,31250.0,9147,1338,10096,1276,19243,2614,53003,66.8,21.0,53003,51.2,17.0
26013,11805,14208,53005,60251.0,62873.0,48844.0,45066.0,70875.0,39209.0,78627,12759,81892,10110,160519,22869,53005,59.9,109.0,53005,44.8,81.0
10466,4799,5667,53007,51837.0,52185.0,40357.0,48194.0,,41889.0,30164,6518,31017,5995,61181,12513,53007,49.8,47.0,53007,38.3,36.0
10682,4864,5818,53009,47253.0,48246.0,,31926.0,38482.0,38636.0,30189,5059,32350,3823,62539,8882,53009,69.6,90.0,53009,51.2,66.0
49314,21861,27453,53011,60756.0,61954.0,42788.0,50500.0,70577.0,41362.0,191398,26615,202078,21962,393476,48577,53011,62.1,266.0,53011,48.0,206.0
690,357,333,53013,38581.0,39696.0,,26667.0,,,1801,152,1772,204,3573,356,53013,62.2,4.0,53013,48.6,4.0
17609,8049,9560,53015,47452.0,48750.0,31250.0,30784.0,40417.0,31954.0,43804,6096,46637,4793,90441,10889,53015,66.3,88.0,53015,53.9,71.0
5835,2677,3158,53017,53636.0,57899.0,,66806.0,,39799.0,16380,3439,16466,3183,32846,6622,53017,42.0,19.0,53017,38.6,17.0
1659,906,753,53019,38125.0,40235.0,,23125.0,,,3358,584,3156,482,6514,1066,53019,46.0,6.0,53019,37.8,4.0
15406,7067,8339,53021,56980.0,61241.0,,,58658.0,41444.0,34404,8573,33744,7554,68148,16127,53021,52.7,27.0,53021,38.5,19.0
252,95,157,53023,45855.0,46912.0,,,,,978,125,988,111,1966,236,53023,,2.0,53023,,
16295,7498,8797,53025,48714.0,51561.0,,40938.0,,40238.0,36748,9464,37816,7528,74564,16992,53025,57.1,49.0,53025,44.5,39.0
12357,5580,6777,53027,43538.0,43743.0,,35900.0,65697.0,34025.0,28006,6113,29766,4657,57772,10770,53027,81.9,81.0,53027,62.6,61.0
7430,3115,4315,53029,58815.0,60077.0,47891.0,58147.0,50933.0,41924.0,32026,3558,35824,2956,67850,6514,53029,48.2,56.0,53029,32.4,38.0
3508,1500,2008,53031,49279.0,49657.0,,38690.0,44848.0,32208.0,12750,1462,13636,1516,26386,2978,53031,55.7,34.0,53031,43.5,27.0
226204,105541,120663,53033,75302.0,80107.0,38696.0,41741.0,82928.0,50430.0,902948,109785,931439,87970,1834387,197755,53033,51.8,972.0,53033,36.4,681.0
26349,11851,14498,53035,62941.0,64380.0,40053.0,42237.0,67014.0,55778.0,105860,12172,114564,9019,220424,21191,53035,60.5,173.0,53035,43.0,123.0
8804,3868,4936,53037,46458.0,47942.0,43314.0,,21990.0,40500.0,18041,2888,18507,2461,36548,5349,53037,47.4,20.0,53037,44.4,18.0
3150,1141,2009,53039,48319.0,48435.0,,47438.0,,54900.0,8931,1312,9304,1230,18235,2542,53039,47.6,15.0,53039,45.1,14.0
12126,5448,6678,53041,44100.0,44557.0,38457.0,38958.0,56979.0,39520.0,31708,5503,33362,4101,65070,9604,53041,61.9,65.0,53041,52.8,56.0
1562,720,842,53043,46069.0,46188.0,,45987.0,45909.0,,4580,558,4572,524,9152,1082,53043,60.9,10.0,53043,49.6,9.0
10166,5632,4534,53045,50406.0,51429.0,,46393.0,62250.0,26328.0,24762,5776,25128,3666,49890,9442,53045,75.9,69.0,53045,54.2,48.0
8646,4399,4247,53047,40730.0,43239.0,24635.0,31044.0,63333.0,32157.0,16363,4244,17129,3081,33492,7325,53047,62.8,36.0,53047,47.1,26.0
3918,1788,2130,53049,37684.0,38842.0,,21958.0,23563.0,35750.0,8472,1709,8944,1273,17416,2982,53049,62.0,24.0,53049,55.9,22.0
2753,1293,1460,53051,40599.0,39945.0,,45000.0,,23816.0,5656,956,5504,741,11160,1697,53051,74.9,15.0,53051,60.6,12.0
102233,45865,56368,53053,59953.0,62352.0,47194.0,44592.0,55991.0,45844.0,342382,49080,366397,41647,708779,90727,53053,76.1,590.0,53053,51.6,396.0
1823,731,1092,53055,55960.0,57025.0,100962.0,45625.0,26923.0,31172.0,6533,1092,7315,961,13848,2053,53055,34.8,11.0,53055,23.9,7.0
18815,8499,10316,53057,54129.0,56057.0,51861.0,39803.0,46250.0,37865.0,49647,8556,52627,7262,102274,15818,53057,63.1,98.0,53057,47.1,74.0
1526,627,899,53059,52374.0,53480.0,,53750.0,52917.0,51944.0,5000,634,4888,683,9888,1317,53059,47.7,7.0,53059,43.8,6.0
74826,33579,41247,53061,70722.0,71401.0,55127.0,55880.0,80146.0,53037.0,324114,43247,333818,35930,657932,79177,53061,64.1,433.0,53061,45.0,300.0
74110,35552,38558,53063,50079.0,51281.0,30725.0,27581.0,41528.0,42766.0,203353,27783,218074,22614,421427,50397,53063,59.8,313.0,53063,47.2,245.0
7753,3573,4180,53065,41978.0,43203.0,,28681.0,22115.0,24444.0,18707,3059,18919,2601,37626,5660,53065,58.7,38.0,53065,42.7,27.0
32101,14506,17595,53067,61677.0,61946.0,65460.0,43558.0,69018.0,54667.0,109470,14498,121226,11366,230696,25864,53067,63.8,180.0,53067,48.1,135.0
674,298,376,53069,44485.0,43897.0,,120500.0,,,1685,234,1875,179,3560,413,53069,55.4,4.0,53069,,
9535,4153,5382,53071,47946.0,47903.0,,,89722.0,47233.0,23430,3994,25935,3006,49365,7000,53071,53.4,37.0,53071,41.6,30.0
32328,14556,17772,53073,53145.0,54744.0,24464.0,31655.0,58662.0,40514.0,88692,12829,92693,11182,181385,24011,53073,59.8,133.0,53073,42.2,95.0
12580,6698,5882,53075,36631.0,39373.0,33750.0,24063.0,25398.0,18287.0,21484,2147,21226,1645,42710,3792,53075,41.7,15.0,53075,31.7,11.0
51694,23973,27721,53077,44749.0,46845.0,24773.0,42934.0,50565.0,37141.0,94384,27518,100082,22537,194466,50055,53077,57.6,137.0,53077,47.2,113.0
2704,1437,1267,55001,43640.0,43713.0,,,,25952.0,8852,1047,8731,623,17583,1670,55001,85.7,32.0,55001,72.7,27.0
2398,1017,1381,55003,39381.0,40877.0,,23523.0,,,7023,857,7210,668,14233,1525,55003,71.4,15.0,55003,64.2,13.0
5640,2618,3022,55005,45714.0,45619.0,74029.0,28438.0,,53529.0,20513,2246,20742,1595,41255,3841,55005,58.9,38.0,55005,47.1,31.0
1719,772,947,55007,46665.0,47444.0,,40724.0,34722.0,58750.0,6840,806,6659,621,13499,1427,55007,54.9,14.0,55007,48.6,12.0
28969,12381,16588,55009,53527.0,55653.0,24574.0,39028.0,57246.0,40367.0,112051,11974,118922,8628,230973,20602,55009,57.9,149.0,55009,41.6,107.0
1500,716,784,55011,50196.0,50007.0,,2499.0,,52500.0,6087,610,6131,404,12218,1014,55011,52.4,10.0,55011,52.6,10.0
2371,1171,1200,55013,41135.0,42180.0,,16935.0,34500.0,33125.0,7002,752,6922,526,13924,1278,55013,75.7,20.0,55013,63.1,17.0
3434,1377,2057,55015,67427.0,67530.0,,93393.0,67115.0,32057.0,23675,1135,23917,764,47592,1899,55015,53.3,27.0,55015,37.3,18.0
6081,2915,3166,55017,52109.0,52195.0,,,44830.0,28523.0,27969,2835,28154,2015,56123,4850,55017,65.8,50.0,55017,48.3,37.0
5504,2419,3085,55019,45048.0,45082.0,,37083.0,,38036.0,12917,4257,13163,3681,26080,7938,55019,52.3,22.0,55019,33.5,14.0
4844,2124,2720,55021,59769.0,60082.0,19563.0,53750.0,81809.0,49583.0,25586,2066,25850,1724,51436,3790,55021,64.3,45.0,55021,45.7,32.0
2023,869,1154,55023,44459.0,44459.0,,33281.0,,33750.0,7223,724,7359,512,14582,1236,55023,62.4,16.0,55023,45.8,12.0
64062,28989,35073,55025,62865.0,66303.0,28106.0,43699.0,55570.0,37257.0,233187,17151,242391,13428,475578,30579,55025,54.3,245.0,55025,38.8,174.0
7658,3436,4222,55027,53783.0,53898.0,60968.0,53750.0,35227.0,43393.0,39787,2809,39114,2204,78901,5013,55027,58.6,65.0,55027,45.6,51.0
2766,1255,1511,55029,51928.0,52221.0,12574.0,78167.0,,36071.0,12515,989,13126,792,25641,1781,55029,53.8,27.0,55029,41.2,21.0
6713,3156,3557,55031,47095.0,47448.0,32045.0,38447.0,,,19364,2166,19725,1950,39089,4116,55031,58.1,31.0,55031,57.9,31.0
6140,2632,3508,55033,49788.0,50069.0,,41848.0,40982.0,,20042,2083,20090,1603,40132,3686,55033,45.4,21.0,55033,34.5,16.0
14862,6739,8123,55035,49513.0,50181.0,14900.0,,33693.0,,44541,4833,47417,3798,91958,8631,55035,57.1,61.0,55035,43.1,46.0
409,160,249,55037,48643.0,48750.0,,37000.0,,61346.0,2117,212,1921,168,4038,380,55037,66.5,5.0,55037,51.4,4.0
9071,3932,5139,55039,55473.0,56085.0,,99509.0,76429.0,45074.0,45814,3550,47977,2919,93791,6469,55039,60.7,76.0,55039,41.8,53.0
1505,729,776,55041,40636.0,40934.0,61667.0,39000.0,,21667.0,3838,706,3760,647,7598,1353,55041,94.7,14.0,55041,48.8,7.0
7318,3707,3611,55043,49067.0,49133.0,,,,48542.0,23530,2547,22298,2000,45828,4547,55043,51.5,33.0,55043,39.7,26.0
3253,1413,1840,55045,56219.0,56748.0,14688.0,,,34940.0,16939,1262,17476,1020,34415,2282,55045,58.6,27.0,55045,41.2,19.0
2274,1143,1131,55047,46780.0,47180.0,40500.0,45357.0,46875.0,31293.0,8270,1201,8267,1029,16537,2230,55047,53.7,15.0,55047,40.7,12.0
2448,1154,1294,55049,55188.0,55340.0,,,,40972.0,10926,886,11228,549,22154,1435,55049,56.0,17.0,55049,37.2,11.0
653,277,376,55051,42543.0,42818.0,,,,45833.0,2598,286,2655,263,5253,549,55051,79.3,9.0,55051,50.5,6.0
2810,1234,1576,55053,47851.0,48354.0,,42027.0,99531.0,42083.0,8752,1133,8570,882,17322,2015,55053,69.0,19.0,55053,50.7,14.0
8597,3917,4680,55055,56877.0,57634.0,44167.0,,30375.0,45387.0,38604,3136,39813,2311,78417,5447,55055,56.2,52.0,55055,38.7,36.0
3567,1754,1813,55057,44961.0,45367.0,38750.0,36750.0,26781.0,43688.0,11261,1407,11465,855,22726,2262,55057,67.5,26.0,55057,54.7,21.0
24823,11271,13552,55059,54918.0,56894.0,27112.0,34063.0,62409.0,36858.0,72812,8862,77613,6584,150425,15446,55059,73.1,120.0,55059,52.7,87.0
1800,762,1038,55061,56863.0,56975.0,,,,55938.0,9778,576,9635,354,19413,930,55061,50.7,14.0,55061,33.2,9.0
16616,7106,9510,55063,50539.0,51020.0,30278.0,37885.0,49523.0,30972.0,52456,4225,55751,3356,108207,7581,55063,60.4,77.0,55063,43.1,55.0
1800,809,991,55065,51445.0,51575.0,,57857.0,,45625.0,7492,966,7453,824,14945,1790,55065,47.5,11.0,55065,35.5,8.0
3063,1523,1540,55067,41775.0,42162.0,,18947.0,,25708.0,8727,909,8809,860,17536,1769,55067,64.2,20.0,55067,50.4,16.0
2800,1249,1551,55069,49721.0,49544.0,,44167.0,,,12683,1144,13038,864,25721,2008,55069,64.1,27.0,55069,47.4,20.0
7957,3304,4653,55071,48398.0,48451.0,,51000.0,41786.0,34167.0,37344,2605,38095,1898,75439,4503,55071,52.2,59.0,55071,38.4,44.0
14095,6537,7558,55073,54083.0,54669.0,40750.0,27292.0,50731.0,32316.0,61200,6094,62787,3920,123987,10014,55073,48.8,78.0,55073,37.7,61.0
5168,2229,2939,55075,43425.0,43383.0,78472.0,36250.0,250001.0,42500.0,18931,1561,19019,1227,37950,2788,55075,72.3,47.0,55075,50.2,33.0
2069,994,1075,55077,46242.0,46266.0,,56250.0,,37813.0,6877,704,6849,551,13726,1255,55077,76.3,19.0,55077,59.2,15.0
1535,735,800,55078,35343.0,50662.0,,32375.0,36667.0,,1427,716,1653,602,3080,1318,55078,80.9,4.0,55078,,
201124,91053,110071,55079,43873.0,53056.0,26853.0,32240.0,51879.0,34006.0,396071,59798,448635,42222,844706,102020,55079,71.1,658.0,55079,52.0,484.0
6676,3011,3665,55081,50694.0,51116.0,,47813.0,,56667.0,19450,2657,20110,2060,39560,4717,55081,77.3,41.0,55081,52.2,28.0
3466,1682,1784,55083,52765.0,53174.0,,52344.0,,28882.0,17497,1497,17166,1051,34663,2548,55083,76.5,39.0,55083,47.2,24.0
3632,1646,1986,55085,46516.0,46718.0,,27782.0,48750.0,55583.0,16064,1601,16488,970,32552,2571,55085,78.2,48.0,55085,53.2,33.0
15723,7230,8493,55087,58765.0,59824.0,40673.0,54397.0,55625.0,38773.0,82663,6476,85176,4627,167839,11103,55087,54.8,99.0,55087,39.6,72.0
4467,1716,2751,55089,76433.0,75758.0,82070.0,,127457.0,56607.0,40545,2024,42586,1561,83131,3585,55089,49.4,55.0,55089,32.5,37.0
947,403,544,55091,49516.0,49677.0,,,,14500.0,3293,370,3209,382,6502,752,55091,53.4,6.0,55091,38.1,4.0
4615,2047,2568,55093,61611.0,62298.0,,,,63947.0,18519,1653,19153,1225,37672,2878,55093,37.6,15.0,55093,36.7,14.0
4407,1978,2429,55095,50714.0,50912.0,30096.0,39107.0,33542.0,50417.0,19563,2138,19648,1782,39211,3920,55095,52.3,31.0,55095,44.7,27.0
10095,5009,5086,55097,51613.0,52562.0,,,24479.0,24375.0,32286,2817,33287,1724,65573,4541,55097,54.3,42.0,55097,38.6,30.0
1860,888,972,55099,43137.0,43083.0,,22813.0,,27031.0,6398,455,6296,455,12694,910,55099,58.0,14.0,55099,47.0,11.0
23768,9979,13789,55101,55584.0,60923.0,26552.0,57045.0,52326.0,36852.0,83220,10012,89921,7615,173141,17627,55101,69.5,153.0,55101,47.5,104.0
2609,1271,1338,55103,44810.0,45092.0,,2499.0,,18611.0,7966,906,8038,695,16004,1601,55103,57.7,14.0,55103,43.6,11.0
23498,10753,12745,55105,50324.0,51736.0,22852.0,25809.0,71917.0,34851.0,69942,8250,75101,6048,145043,14298,55105,74.9,139.0,55105,54.5,101.0
2252,1121,1131,55107,39194.0,39069.0,,18438.0,46563.0,60208.0,6262,886,6450,621,12712,1507,55107,76.0,18.0,55107,55.7,13.0
5502,2468,3034,55109,70886.0,71315.0,25817.0,22237.0,79688.0,44219.0,39513,2938,40514,2392,80027,5330,55109,45.4,35.0,55109,37.9,29.0
7656,3355,4301,55111,51055.0,51580.0,16728.0,40156.0,,45965.0,28199,2991,28541,2533,56740,5524,55111,57.3,44.0,55111,50.0,39.0
2673,1195,1478,55113,41665.0,44169.0,23750.0,30773.0,25625.0,36964.0,7117,1018,7312,728,14429,1746,55113,67.3,18.0,55113,54.9,15.0
4451,1998,2453,55115,47861.0,48485.0,11250.0,40313.0,53125.0,32500.0,18453,2016,18780,1709,37233,3725,55115,55.0,33.0,55115,44.9,27.0
10348,4731,5617,55117,53713.0,53853.0,27042.0,50938.0,55183.0,44219.0,51687,4580,53467,3184,105154,7764,55117,60.6,84.0,55117,45.2,63.0
2527,1150,1377,55119,45420.0,45509.0,,,,40921.0,9110,1300,9115,813,18225,2113,55119,47.4,13.0,55119,29.4,8.0
3078,1355,1723,55121,51077.0,52104.0,,,,40536.0,13246,1379,13470,889,26716,2268,55121,57.9,21.0,55121,47.1,18.0
4757,2125,2632,55123,47675.0,47927.0,,,,30938.0,12288,2659,12561,2463,24849,5122,55123,55.0,23.0,55123,43.5,19.0
3047,1365,1682,55125,41061.0,42373.0,,18950.0,,41974.0,9450,1164,9854,710,19304,1874,55125,66.9,28.0,55125,48.1,21.0
13499,5855,7644,55127,53445.0,54121.0,24583.0,,61250.0,44681.0,45658,5450,47291,3835,92949,9285,55127,64.0,75.0,55127,46.2,54.0
2022,911,1111,55129,42368.0,42741.0,25962.0,43750.0,61389.0,21500.0,6874,832,7253,554,14127,1386,55129,71.5,19.0,55129,53.8,14.0
7375,2950,4425,55131,69237.0,69459.0,64933.0,112946.0,81713.0,50810.0,62004,3345,63727,2899,125731,6244,55131,57.3,89.0,55131,39.5,61.0
20433,8852,11581,55133,76545.0,76593.0,31865.0,74091.0,114511.0,55123.0,182973,9129,191505,7700,374478,16829,55133,54.6,262.0,55133,39.8,191.0
5232,2328,2904,55135,51994.0,52276.0,48839.0,46904.0,27250.0,32917.0,23435,2093,23613,1501,47048,3594,55135,64.7,48.0,55135,50.4,38.0
2385,1092,1293,55137,45166.0,45540.0,,,,43750.0,10355,1332,10471,1011,20826,2343,55137,72.0,28.0,55137,50.7,20.0
19209,8291,10918,55139,52018.0,52567.0,26281.0,31573.0,52813.0,41099.0,74590,6032,78495,4794,153085,10826,55139,62.2,117.0,55139,44.7,85.0
7996,3644,4352,55141,48961.0,48740.0,51660.0,31413.0,85527.0,34483.0,33602,2741,35148,1845,68750,4586,55141,57.4,58.0,55141,40.3,42.0
3482,1682,1800,54001,37066.0,37197.0,,,,,6927,1173,7434,1040,14361,2213,54001,58.8,13.0,54001,42.9,9.0
15235,6801,8434,54003,55239.0,55898.0,49063.0,,105962.0,53707.0,47309,5793,49115,5848,96424,11641,54003,83.7,92.0,54003,65.1,69.0
5529,2643,2886,54005,39958.0,39991.0,26875.0,,77188.0,,10532,1330,10908,1114,21440,2444,54005,111.8,34.0,54005,81.5,25.0
2941,1496,1445,54007,32750.0,33206.0,,,,,6032,961,6145,971,12177,1932,54007,72.4,16.0,54007,61.4,13.0
2960,1290,1670,54009,46215.0,46196.0,,,,58594.0,10230,1236,11001,1006,21231,2242,54009,64.7,24.0,54009,54.5,21.0
20110,8964,11146,54011,38344.0,39722.0,17396.0,23580.0,54766.0,34814.0,40407,5898,44087,5004,84494,10902,54011,89.9,109.0,54011,64.3,79.0
1314,569,745,54013,35568.0,36829.0,,,,61063.0,3209,567,3072,686,6281,1253,54013,90.9,11.0,54013,79.0,9.0
2530,1119,1411,54015,31325.0,30933.0,,,,,3955,603,4026,498,7981,1101,54015,99.8,13.0,54015,70.6,9.0
1190,457,733,54017,39974.0,40819.0,,,,,3243,662,3175,536,6418,1198,54017,40.0,4.0,54017,52.3,6.0
8683,3956,4727,54019,36293.0,36475.0,33007.0,57895.0,,32188.0,18691,3142,19390,2986,38081,6128,54019,87.6,56.0,54019,73.5,47.0
1781,977,804,54021,37536.0,39438.0,,,,,3146,508,2909,501,6055,1009,54021,46.8,5.0,54021,47.5,5.0
1791,882,909,54023,39088.0,39098.0,,,,,5242,612,5419,432,10661,1044,54023,52.7,9.0,54023,40.4,7.0
6530,2939,3591,54025,39746.0,40752.0,35523.0,,2499.0,34816.0,14842,2261,15908,2024,30750,4285,54025,67.8,38.0,54025,48.6,26.0
4721,2317,2404,54027,27995.0,28796.0,18271.0,,,,9515,2254,9704,1538,19219,3792,54027,83.8,27.0,54027,63.5,20.0
4835,2034,2801,54029,39959.0,40000.0,24716.0,76354.0,,,13027,1533,13682,1731,26709,3264,54029,78.9,36.0,54029,62.4,29.0
1863,773,1090,54031,40303.0,41394.0,33973.0,,18065.0,21103.0,6160,846,6168,704,12328,1550,54031,68.8,13.0,54031,39.4,8.0
11072,4992,6080,54033,43987.0,44182.0,33229.0,,,41809.0,29328,4163,31103,3815,60431,7978,54033,87.3,82.0,54033,61.5,58.0
4743,2268,2475,54035,41314.0,41576.0,,,,,13027,1410,13302,1341,26329,2751,54035,74.3,31.0,54035,63.7,26.0
6222,2521,3701,54037,66677.0,66801.0,70478.0,,,65682.0,23866,3089,25503,2490,49369,5579,54037,71.0,41.0,54037,51.6,30.0
29703,13258,16445,54039,45882.0,46985.0,28913.0,25750.0,78125.0,55272.0,80160,10691,88818,9372,168978,20063,54039,87.3,231.0,54039,64.5,170.0
3357,1583,1774,54041,37849.0,37854.0,,,48125.0,,7138,1004,7214,992,14352,1996,54041,100.1,25.0,54041,64.6,15.0
5870,2758,3112,54043,35800.0,35870.0,,,,,9453,1235,9667,1145,19120,2380,54043,111.5,32.0,54043,77.3,22.0
6902,2915,3987,54045,36763.0,36929.0,,,,37050.0,14693,2538,15770,2187,30463,4725,54045,115.7,56.0,54045,95.1,45.0
6943,3196,3747,54047,24921.0,25338.0,21730.0,,,,7748,1595,8604,1653,16352,3248,54047,103.9,32.0,54047,86.6,26.0
8980,4005,4975,54049,43165.0,44479.0,23850.0,,43750.0,76250.0,24474,3170,25607,3172,50081,6342,54049,77.5,61.0,54049,60.7,46.0
4128,1676,2452,54051,45182.0,45314.0,,,,33250.0,13971,1738,14765,1607,28736,3345,54051,72.8,34.0,54051,50.4,24.0
5075,2409,2666,54053,36448.0,36003.0,,,,,11796,1296,12095,1313,23891,2609,54053,87.6,34.0,54053,74.4,28.0
13236,5322,7914,54055,36195.0,37035.0,22448.0,18971.0,,,25765,3623,28569,3502,54334,7125,54055,84.0,75.0,54055,65.2,59.0
4562,2071,2491,54057,31790.0,32371.0,9276.0,,231544.0,,11880,1750,11854,2065,23734,3815,54057,82.3,32.0,54057,65.2,26.0
6654,2873,3781,54059,33221.0,33791.0,24730.0,,,,11009,1662,11547,1629,22556,3291,54059,106.5,35.0,54059,83.1,27.0
20923,10509,10414,54061,45467.0,46312.0,26667.0,,52232.0,21985.0,46145,5157,44376,4373,90521,9530,54061,65.9,56.0,54061,43.2,36.0
2252,894,1358,54063,36918.0,37511.0,15590.0,,,41270.0,5882,761,5852,912,11734,1673,54063,63.3,13.0,54063,46.0,10.0
2218,879,1339,54065,39324.0,38936.0,,,124219.0,46354.0,7057,1471,7458,1323,14515,2794,54065,68.9,18.0,54065,57.9,15.0
4636,2006,2630,54067,39171.0,39134.0,,,,,11361,1372,11541,1512,22902,2884,54067,67.5,25.0,54067,66.3,25.0
6658,2958,3700,54069,40569.0,41507.0,21202.0,,50750.0,,18578,2150,20274,2075,38852,4225,54069,73.5,47.0,54069,52.8,35.0
1500,776,724,54071,36953.0,37000.0,,,,,3204,399,3191,435,6395,834,54071,44.2,6.0,54071,35.6,5.0
1260,616,644,54073,44288.0,44919.0,,,,,3159,334,3257,266,6416,600,54073,98.3,10.0,54073,75.6,8.0
1382,568,814,54075,36827.0,37415.0,,,,,3544,655,3740,453,7284,1108,54075,78.2,11.0,54075,55.9,8.0
4574,2002,2572,54077,45064.0,45167.0,,48125.0,,50729.0,13622,2010,14136,1716,27758,3726,54077,68.1,31.0,54077,45.8,20.0
5494,2026,3468,54079,56774.0,57218.0,,,,61034.0,25264,2324,26190,2483,51454,4807,54079,76.1,52.0,54079,48.0,33.0
13322,5897,7425,54081,41032.0,42058.0,23850.0,68547.0,56058.0,,32067,4667,34436,4328,66503,8995,54081,81.0,86.0,54081,59.8,64.0
4610,1968,2642,54083,39457.0,39283.0,,,,9500.0,11948,1779,12104,1717,24052,3496,54083,63.3,27.0,54083,50.7,20.0
2071,995,1076,54085,37636.0,38091.0,,,,,4232,754,4496,591,8728,1345,54085,105.7,16.0,54085,81.5,12.0
3165,1382,1783,54087,31813.0,31854.0,,35625.0,62500.0,22778.0,6351,829,6571,791,12922,1620,54087,76.5,16.0,54087,65.2,14.0
2184,1100,1084,54089,36651.0,37903.0,29222.0,,,,5359,752,5793,539,11152,1291,54089,54.1,11.0,54089,36.5,8.0
2731,1296,1435,54091,43970.0,44576.0,35234.0,,,,7287,967,7477,801,14764,1768,54091,72.2,17.0,54091,68.5,15.0
1013,450,563,54093,40533.0,40922.0,,,,,3067,301,3069,363,6136,664,54093,75.3,9.0,54093,49.7,6.0
1765,675,1090,54095,38854.0,39149.0,,,,,3826,615,3884,634,7710,1249,54095,81.0,11.0,54095,64.0,9.0
4189,1928,2261,54097,40330.0,40803.0,,,,,10452,1736,10744,1471,21196,3207,54097,74.0,24.0,54097,59.9,19.0
8468,3971,4497,54099,36318.0,36313.0,,,246300.0,72571.0,17510,2711,18273,2887,35783,5598,54099,89.5,51.0,54099,64.2,36.0
2307,1033,1274,54101,29086.0,29295.0,,,,,3713,652,3833,671,7546,1323,54101,94.6,13.0,54101,81.0,10.0
3169,1354,1815,54103,39096.0,39301.0,,,,,6968,930,7266,895,14234,1825,54103,87.0,22.0,54103,71.2,18.0
792,291,501,54105,39352.0,38873.0,,,,,2685,251,2492,413,5177,664,54105,78.8,7.0,54105,54.6,4.0
14825,6309,8516,54107,41884.0,42134.0,31188.0,52742.0,,32500.0,36251,5402,40175,4243,76426,9645,54107,81.9,97.0,54107,60.5,71.0
4934,2320,2614,54109,33730.0,33828.0,,,,,9990,1311,10135,1352,20125,2663,54109,90.3,27.0,54109,80.0,24.0
9510,4748,4762,56001,42834.0,43768.0,,,21437.0,37286.0,17650,1926,16276,1516,33926,3442,56001,40.8,11.0,56001,29.1,8.0
1408,632,776,56003,51679.0,51894.0,,,47917.0,40000.0,4937,968,4867,900,9804,1868,56003,41.8,7.0,56003,40.2,7.0
3412,1380,2032,56005,80060.0,81018.0,,70833.0,82750.0,60970.0,21583,3092,19806,3159,41389,6251,56005,53.1,16.0,56005,60.1,16.0
2280,948,1332,56007,56825.0,58156.0,30923.0,110114.0,,43472.0,6819,1089,6058,996,12877,2085,56007,58.4,10.0,56007,41.6,7.0
1308,486,822,56009,62307.0,62073.0,,85391.0,,69615.0,6497,587,6052,902,12549,1489,56009,58.3,9.0,56009,40.6,6.0
362,206,156,56011,60445.0,60685.0,,,,35089.0,3201,479,3060,440,6261,919,56011,46.2,5.0,56011,47.6,5.0
5637,2586,3051,56013,52773.0,54942.0,32083.0,45569.0,39412.0,37596.0,15856,4060,16468,3762,32324,7822,56013,45.7,22.0,56013,38.6,19.0
2261,1048,1213,56015,42689.0,44524.0,,40714.0,,40417.0,5672,964,5569,723,11241,1687,56015,52.5,10.0,56015,40.5,8.0
500,140,360,56017,45278.0,45521.0,,,,,1942,395,2048,319,3990,714,56017,75.8,7.0,56017,50.3,4.0
534,294,240,56019,54065.0,53975.0,,,,,4058,449,3660,379,7718,828,56019,38.2,5.0,56019,29.9,4.0
9369,3777,5592,56021,60706.0,63653.0,48929.0,,,42148.0,40089,5563,41797,4991,81886,10554,56021,52.1,53.0,56021,42.3,42.0
1435,662,773,56023,66647.0,66896.0,,55750.0,38958.0,39258.0,8316,1002,7928,941,16244,1943,56023,32.1,7.0,56023,26.8,5.0
8407,3605,4802,56025,56871.0,58367.0,24891.0,41949.0,,40732.0,33677,6119,33595,5518,67272,11637,56025,58.2,48.0,56025,41.5,35.0
328,154,174,56027,40398.0,40739.0,,,,,1011,142,931,148,1942,290,56027,,2.0,56027,,
2024,492,1532,56029,56363.0,56992.0,35653.0,51000.0,,50625.0,12141,1955,12766,1857,24907,3812,56029,36.3,15.0,56029,34.2,14.0
1391,562,829,56031,38500.0,40133.0,,,,17946.0,3579,837,3622,602,7201,1439,56031,52.0,7.0,56031,40.0,6.0
2381,1210,1171,56033,55455.0,56134.0,,60461.0,,48021.0,12684,1703,13415,1471,26099,3174,56033,52.0,20.0,56033,42.0,15.0
812,453,359,56035,81772.0,79590.0,,,,127586.0,4509,822,4067,697,8576,1519,56035,,2.0,56035,,
5058,2177,2881,56037,69022.0,69333.0,23535.0,,,53175.0,19891,3318,18600,2683,38491,6001,56037,39.9,14.0,56037,28.4,9.0
1638,1026,612,56039,75325.0,77651.0,,,,41619.0,8948,2558,9555,1192,18503,3750,56039,23.7,5.0,56039,29.1,5.0
2845,1453,1392,56041,56569.0,56532.0,,,,40194.0,9132,1413,8711,1503,17843,2916,56041,31.7,6.0,56041,22.1,4.0
1137,489,648,56043,47652.0,48110.0,,,,29740.0,3349,691,3490,703,6839,1394,56043,50.0,6.0,56043,38.2,5.0
958,354,604,56045,57738.0,57842.0,,,,31875.0,2927,454,3087,314,6014,768,56045,44.9,4.0,56045,43.5,4.0
